Datum;VPE_Gesamt;Komm_VPE;Voll;Displays;Lager
02.01.15;83685;82045;1640;0;DPS
03.01.15;83810;82211;1599;0;DPS
05.01.15;74101;72968;1133;0;DPS
06.01.15;56912;55420;1492;0;DPS
07.01.15;58630;57006;1624;0;DPS
08.01.15;72051;68311;3740;0;DPS
09.01.15;58041;56824;1217;0;DPS
10.01.15;21672;21248;424;0;DPS
12.01.15;73898;72765;1133;0;DPS
13.01.15;53459;52345;1114;0;DPS
14.01.15;52110;50914;1196;0;DPS
15.01.15;62454;60623;1831;0;DPS
16.01.15;55834;54984;850;0;DPS
17.01.15;24656;24309;347;0;DPS
19.01.15;84728;83523;1205;0;DPS
20.01.15;58344;56842;1502;0;DPS
21.01.15;54343;52470;1873;0;DPS
22.01.15;65395;63267;2128;0;DPS
23.01.15;55526;54137;1389;0;DPS
24.01.15;23736;23368;368;0;DPS
26.01.15;88342;86547;1795;0;DPS
27.01.15;52434;51300;1134;0;DPS
28.01.15;56326;54271;2055;0;DPS
29.01.15;63743;60092;3651;0;DPS
30.01.15;53519;52369;1150;0;DPS
31.01.15;28822;28377;445;0;DPS
02.02.15;93141;91675;1466;0;DPS
03.02.15;59432;58348;1084;0;DPS
04.02.15;57033;55865;1168;0;DPS
05.02.15;67059;65988;1071;0;DPS
06.02.15;57132;56136;996;0;DPS
07.02.15;26251;25875;376;0;DPS
09.02.15;87668;86019;1649;0;DPS
10.02.15;53169;52327;842;0;DPS
11.02.15;52658;51713;945;0;DPS
12.02.15;69310;68067;1243;0;DPS
13.02.15;51695;50691;1004;0;DPS
14.02.15;29121;26581;2540;0;DPS
16.02.15;87992;86722;1270;0;DPS
17.02.15;54779;53710;1069;0;DPS
18.02.15;52433;50977;1456;0;DPS
19.02.15;70212;68460;1752;0;DPS
20.02.15;55238;54150;1088;0;DPS
21.02.15;26096;25589;507;0;DPS
23.02.15;84301;82956;1345;0;DPS
24.02.15;52944;51814;1130;0;DPS
25.02.15;53885;52472;1413;0;DPS
26.02.15;70776;69703;1073;0;DPS
27.02.15;58196;57167;1029;0;DPS
28.02.15;27350;26398;952;0;DPS
02.03.15;87937;86509;1428;0;DPS
03.03.15;56940;55791;1149;0;DPS
04.03.15;59853;57907;1946;0;DPS
05.03.15;72774;71345;1429;0;DPS
06.03.15;58286;57200;1086;0;DPS
07.03.15;22351;22012;339;0;DPS
09.03.15;82549;81494;1055;0;DPS
10.03.15;51158;50555;603;0;DPS
11.03.15;48265;47323;942;0;DPS
12.03.15;64873;64004;869;0;DPS
13.03.15;52943;52062;881;0;DPS
14.03.15;22856;22528;328;0;DPS
16.03.15;84841;83753;1088;0;DPS
17.03.15;51864;51016;848;0;DPS
18.03.15;52786;51836;950;0;DPS
19.03.15;66683;65667;1016;0;DPS
20.03.15;52587;51830;757;0;DPS
21.03.15;23412;23018;394;0;DPS
23.03.15;81374;80261;1113;0;DPS
24.03.15;48755;47487;1268;0;DPS
25.03.15;51332;50020;1312;0;DPS
26.03.15;70762;69585;1177;0;DPS
27.03.15;56219;55317;902;0;DPS
28.03.15;32335;31705;630;0;DPS
30.03.15;89218;88063;1155;0;DPS
31.03.15;57224;56286;938;0;DPS
01.04.15;58977;53584;5393;0;DPS
02.04.15;60927;59795;1132;0;DPS
03.04.15;15756;15343;413;0;DPS
04.04.15;15795;15616;179;0;DPS
07.04.15;74550;73753;797;0;DPS
08.04.15;75936;74474;1462;0;DPS
09.04.15;85054;83191;1863;0;DPS
10.04.15;76109;75256;853;0;DPS
11.04.15;66173;65374;799;0;DPS
13.04.15;61142;60245;897;0;DPS
14.04.15;56871;56294;577;0;DPS
15.04.15;49118;47757;1361;0;DPS
16.04.15;61841;60931;910;0;DPS
17.04.15;50609;49767;842;0;DPS
18.04.15;31861;31215;646;0;DPS
20.04.15;81208;79651;1557;0;DPS
21.04.15;55123;53475;1648;0;DPS
22.04.15;45695;44346;1349;0;DPS
23.04.15;59092;58101;991;0;DPS
24.04.15;52034;50891;1143;0;DPS
25.04.15;34420;33871;549;0;DPS
27.04.15;82032;80478;1554;0;DPS
28.04.15;55373;53726;1647;0;DPS
29.04.15;59674;56695;2979;0;DPS
30.04.15;61724;60502;1222;0;DPS
01.05.15;18119;17603;516;0;DPS
02.05.15;13924;13770;154;0;DPS
04.05.15;79848;78769;1079;0;DPS
05.05.15;81910;80587;1323;0;DPS
06.05.15;66046;64658;1388;0;DPS
07.05.15;79573;77966;1607;0;DPS
08.05.15;62068;60790;1278;0;DPS
09.05.15;31271;30574;697;0;DPS
11.05.15;78196;77207;989;0;DPS
12.05.15;54101;53152;949;0;DPS
13.05.15;64756;63841;915;0;DPS
15.05.15;66077;65085;992;0;DPS
16.05.15;63739;62675;1064;0;DPS
18.05.15;69145;68196;949;0;DPS
19.05.15;61285;60409;876;0;DPS
20.05.15;62738;61667;1071;0;DPS
21.05.15;73012;71593;1419;0;DPS
22.05.15;60363;58908;1455;0;DPS
23.05.15;34882;34072;810;0;DPS
26.05.15;71878;69751;2127;0;DPS
27.05.15;50448;48684;1764;0;DPS
28.05.15;66363;63603;2760;0;DPS
29.05.15;60318;58837;1481;0;DPS
30.05.15;63616;62302;1314;0;DPS
01.06.15;67924;66229;1695;0;DPS
02.06.15;66355;62988;3367;0;DPS
03.06.15;53262;51609;1653;0;DPS
04.06.15;63134;61493;1641;0;DPS
05.06.15;58227;56552;1675;0;DPS
06.06.15;31546;30414;1132;0;DPS
08.06.15;71217;69413;1804;0;DPS
09.06.15;49532;48272;1260;0;DPS
10.06.15;52496;50130;2366;0;DPS
11.06.15;65287;62939;2348;0;DPS
12.06.15;52067;50740;1327;0;DPS
15.06.15;80329;77982;2347;0;DPS
16.06.15;53893;52428;1465;0;DPS
17.06.15;52512;50796;1716;0;DPS
18.06.15;65421;63353;2068;0;DPS
19.06.15;55966;53999;1967;0;DPS
20.06.15;33896;33020;876;0;DPS
22.06.15;74781;72858;1923;0;DPS
23.06.15;50576;49023;1553;0;DPS
24.06.15;50697;48194;2503;0;DPS
25.06.15;67099;64948;2151;0;DPS
26.06.15;53294;51897;1397;0;DPS
27.06.15;31217;30324;893;0;DPS
29.06.15;75664;73324;2340;0;DPS
30.06.15;55586;52441;3145;0;DPS
01.07.15;57090;53864;3226;0;DPS
02.07.15;73107;69123;3984;0;DPS
03.07.15;63546;62175;1371;0;DPS
04.07.15;32019;30870;1149;0;DPS
06.07.15;75871;74352;1519;0;DPS
07.07.15;57661;53533;4128;0;DPS
08.07.15;57891;55740;2151;0;DPS
09.07.15;70046;68363;1683;0;DPS
10.07.15;55135;53753;1382;0;DPS
11.07.15;33388;32480;908;0;DPS
13.07.15;81248;79058;2190;0;DPS
14.07.15;64678;62448;2230;0;DPS
15.07.15;63557;60544;3013;0;DPS
16.07.15;73669;72038;1631;0;DPS
17.07.15;60652;59029;1623;0;DPS
18.07.15;27171;26352;819;0;DPS
20.07.15;75720;73590;2130;0;DPS
21.07.15;54976;53613;1363;0;DPS
22.07.15;57030;54414;2616;0;DPS
23.07.15;67458;65824;1634;0;DPS
24.07.15;53618;52213;1405;0;DPS
25.07.15;33144;31311;1833;0;DPS
27.07.15;74545;72893;1652;0;DPS
28.07.15;51539;50092;1447;0;DPS
29.07.15;48223;46306;1917;0;DPS
30.07.15;63962;62236;1726;0;DPS
31.07.15;56213;54248;1965;0;DPS
01.08.15;36976;34662;2314;0;DPS
03.08.15;76544;74797;1747;0;DPS
04.08.15;48795;47026;1769;0;DPS
05.08.15;57046;54925;2121;0;DPS
06.08.15;68673;66505;2168;0;DPS
07.08.15;54541;52319;2222;0;DPS
08.08.15;32094;30889;1205;0;DPS
10.08.15;70945;69189;1756;0;DPS
11.08.15;51209;49591;1618;0;DPS
12.08.15;52147;49685;2462;0;DPS
13.08.15;67767;64732;3035;0;DPS
14.08.15;51750;50414;1336;0;DPS
15.08.15;32081;30595;1486;0;DPS
17.08.15;68483;66727;1756;0;DPS
18.08.15;50688;49208;1480;0;DPS
19.08.15;49338;47285;2053;0;DPS
20.08.15;64402;62522;1880;0;DPS
21.08.15;55549;54264;1285;0;DPS
22.08.15;28521;27663;858;0;DPS
24.08.15;70473;68747;1726;0;DPS
25.08.15;57202;55489;1713;0;DPS
26.08.15;63367;60323;3044;0;DPS
27.08.15;69415;66853;2562;0;DPS
28.08.15;56573;55220;1353;0;DPS
29.08.15;32865;31912;953;0;DPS
31.08.15;79931;78106;1825;0;DPS
01.09.15;55281;53258;2023;0;DPS
02.09.15;60138;58133;2005;0;DPS
03.09.15;78058;74708;3350;0;DPS
04.09.15;61053;59649;1404;0;DPS
05.09.15;33951;32805;1146;0;DPS
07.09.15;80966;78782;2184;0;DPS
08.09.15;55029;53401;1628;0;DPS
09.09.15;51646;49957;1689;0;DPS
10.09.15;68330;66583;1747;0;DPS
11.09.15;54835;53342;1493;0;DPS
12.09.15;34854;31908;2946;0;DPS
14.09.15;76121;74418;1703;0;DPS
15.09.15;45774;44609;1165;0;DPS
16.09.15;49149;47763;1386;0;DPS
17.09.15;66011;63560;2451;0;DPS
18.09.15;53512;52389;1123;0;DPS
19.09.15;32154;31375;779;0;DPS
21.09.15;74851;73089;1762;0;DPS
22.09.15;48700;47297;1403;0;DPS
23.09.15;54731;52746;1985;0;DPS
24.09.15;65237;63686;1551;0;DPS
25.09.15;56469;54937;1532;0;DPS
26.09.15;32221;31391;830;0;DPS
28.09.15;75449;73464;1985;0;DPS
29.09.15;52286;50371;1915;0;DPS
30.09.15;51282;49388;1894;0;DPS
01.10.15;54435;52677;1758;0;DPS
02.10.15;62409;60093;2316;0;DPS
05.10.15;64785;62955;1830;0;DPS
06.10.15;62658;56490;6168;0;DPS
07.10.15;67766;65525;2241;0;DPS
08.10.15;69414;67457;1957;0;DPS
09.10.15;60394;58661;1733;0;DPS
10.10.15;36540;35161;1379;0;DPS
12.10.15;84042;81579;2463;0;DPS
13.10.15;49690;48014;1676;0;DPS
14.10.15;50831;47968;2863;0;DPS
15.10.15;65193;62908;2285;0;DPS
16.10.15;52325;50536;1789;0;DPS
17.10.15;33884;29629;4255;0;DPS
19.10.15;76625;73759;2866;0;DPS
20.10.15;62117;58901;3216;0;DPS
21.10.15;60293;57359;2934;0;DPS
22.10.15;74324;69556;4768;0;DPS
23.10.15;52084;50428;1656;0;DPS
24.10.15;26807;24867;1940;0;DPS
26.10.15;67628;65181;2447;0;DPS
28.10.15;51063;47602;3461;0;DPS
29.10.15;62916;59906;3010;0;DPS
30.10.15;53627;51198;2429;0;DPS
31.10.15;25186;24005;1181;0;DPS
02.11.15;81909;77943;3966;0;DPS
03.11.15;45980;44508;1472;0;DPS
05.11.15;66778;63292;3486;0;DPS
06.11.15;54060;51022;3038;0;DPS
07.11.15;33270;31831;1439;0;DPS
09.11.15;82075;78233;3842;0;DPS
10.11.15;59573;52570;7003;0;DPS
11.11.15;57279;54497;2782;0;DPS
12.11.15;78847;64004;14843;0;DPS
13.11.15;51856;49996;1860;0;DPS
14.11.15;28844;27603;1241;0;DPS
16.11.15;82159;79090;3069;0;DPS
17.11.15;58238;55670;2568;0;DPS
18.11.15;55082;52917;2165;0;DPS
19.11.15;66376;63749;2627;0;DPS
20.11.15;52960;51249;1711;0;DPS
21.11.15;31184;29637;1547;0;DPS
23.11.15;79164;76189;2975;0;DPS
24.11.15;56657;53544;3113;0;DPS
25.11.15;61010;58169;2841;0;DPS
26.11.15;60872;58091;2781;0;DPS
27.11.15;59539;57160;2379;0;DPS
28.11.15;63640;61581;2059;0;DPS
30.11.15;79171;76422;2749;0;DPS
01.12.15;76624;74437;2187;0;DPS
02.12.15;60635;58982;1653;0;DPS
03.12.15;63496;61780;1716;0;DPS
04.12.15;57668;56169;1499;0;DPS
05.12.15;65024;63281;1743;0;DPS
07.12.15;68270;66787;1483;0;DPS
08.12.15;56999;55637;1362;0;DPS
09.12.15;52444;51031;1413;0;DPS
10.12.15;58323;56652;1671;0;DPS
11.12.15;55217;53925;1292;0;DPS
12.12.15;69573;67665;1908;0;DPS
14.12.15;73537;71954;1583;0;DPS
15.12.15;68272;66854;1418;0;DPS
16.12.15;58917;57319;1598;0;DPS
17.12.15;67691;66191;1500;0;DPS
18.12.15;72383;70644;1739;0;DPS
19.12.15;75729;74146;1583;0;DPS
21.12.15;75913;74096;1817;0;DPS
22.12.15;96825;94203;2622;0;DPS
23.12.15;64480;62860;1620;0;DPS
24.12.15;32782;31762;1020;0;DPS
28.12.15;84081;82108;1973;0;DPS
29.12.15;65105;63462;1643;0;DPS
30.12.15;61840;60511;1329;0;DPS
31.12.15;29954;29113;841;0;DPS
02.01.16;68509;66813;1696;0;DPS
04.01.16;61479;59571;1908;0;DPS
05.01.16;61575;58824;2751;0;DPS
06.01.16;48242;47073;1169;0;DPS
07.01.16;62918;60180;2738;0;DPS
08.01.16;53277;51996;1281;0;DPS
09.01.16;29807;28576;1231;0;DPS
11.01.16;66002;64294;1708;0;DPS
12.01.16;43548;42047;1501;0;DPS
13.01.16;47777;44972;2805;0;DPS
14.01.16;59242;57211;2031;0;DPS
15.01.16;52739;51239;1500;0;DPS
16.01.16;28296;27440;856;0;DPS
18.01.16;78812;76529;2283;0;DPS
19.01.16;56815;55339;1476;0;DPS
20.01.16;43397;42176;1221;0;DPS
21.01.16;56175;54775;1400;0;DPS
22.01.16;52433;51316;1117;0;DPS
23.01.16;24525;23488;1037;0;DPS
25.01.16;69128;67783;1345;0;DPS
26.01.16;47441;46421;1020;0;DPS
27.01.16;47759;46565;1194;0;DPS
28.01.16;61085;59960;1125;0;DPS
29.01.16;57840;56882;958;0;DPS
30.01.16;32453;31197;1256;0;DPS
01.02.16;77534;75682;1852;0;DPS
02.02.16;55987;54652;1335;0;DPS
03.02.16;49980;48958;1022;0;DPS
04.02.16;64421;63236;1185;0;DPS
05.02.16;54457;53482;975;0;DPS
06.02.16;31586;31011;575;0;DPS
08.02.16;74506;73179;1327;0;DPS
09.02.16;51483;50344;1139;0;DPS
10.02.16;44466;43681;785;0;DPS
11.02.16;62705;61543;1162;0;DPS
12.02.16;54200;53066;1134;0;DPS
13.02.16;31623;30824;799;0;DPS
15.02.16;81370;79766;1604;0;DPS
16.02.16;58078;56958;1120;0;DPS
17.02.16;44472;43435;1037;0;DPS
18.02.16;66304;60455;5849;0;DPS
19.02.16;54811;53903;908;0;DPS
20.02.16;30408;29788;620;0;DPS
22.02.16;72453;70519;1934;0;DPS
23.02.16;48075;46288;1787;0;DPS
24.02.16;46300;44790;1510;0;DPS
25.02.16;60816;59487;1329;0;DPS
26.02.16;62318;61450;868;0;DPS
27.02.16;30410;29835;575;0;DPS
29.02.16;80367;78679;1688;0;DPS
01.03.16;60721;59507;1214;0;DPS
02.03.16;48205;47222;983;0;DPS
03.03.16;71183;70005;1178;0;DPS
04.03.16;60733;59716;1017;0;DPS
05.03.16;32814;32148;666;0;DPS
07.03.16;79771;78298;1473;0;DPS
08.03.16;54619;52133;2486;0;DPS
09.03.16;45671;44705;966;0;DPS
10.03.16;62454;61301;1153;0;DPS
11.03.16;57746;56660;1086;0;DPS
12.03.16;29240;28723;517;0;DPS
14.03.16;73352;71958;1394;0;DPS
15.03.16;54473;53278;1195;0;DPS
16.03.16;42049;40922;1127;0;DPS
17.03.16;61187;60036;1151;0;DPS
18.03.16;54129;53101;1028;0;DPS
19.03.16;33485;32932;553;0;DPS
21.03.16;75587;74463;1124;0;DPS
22.03.16;52999;51728;1271;0;DPS
23.03.16;58200;57041;1159;0;DPS
24.03.16;62018;60799;1219;0;DPS
26.03.16;49945;49023;922;0;DPS
29.03.16;65400;63770;1630;0;DPS
30.03.16;51262;50364;898;0;DPS
31.03.16;72181;70926;1255;0;DPS
01.04.16;68244;67056;1188;0;DPS
02.04.16;43204;42235;969;0;DPS
04.04.16;87376;85636;1740;0;DPS
05.04.16;58894;57927;967;0;DPS
06.04.16;45862;44937;925;0;DPS
07.04.16;62716;61753;963;0;DPS
08.04.16;53675;52824;851;0;DPS
09.04.16;25593;25020;573;0;DPS
11.04.16;83274;81707;1567;0;DPS
12.04.16;58371;57471;900;0;DPS
13.04.16;42393;41583;810;0;DPS
14.04.16;62570;61524;1046;0;DPS
15.04.16;52632;51704;928;0;DPS
16.04.16;22667;22172;495;0;DPS
18.04.16;69010;67491;1519;0;DPS
19.04.16;52794;51386;1408;0;DPS
20.04.16;45309;44445;864;0;DPS
21.04.16;63483;62466;1017;0;DPS
22.04.16;53331;52407;924;0;DPS
23.04.16;23008;22415;593;0;DPS
25.04.16;75981;74475;1506;0;DPS
26.04.16;57025;55939;1086;0;DPS
27.04.16;46697;45787;910;0;DPS
28.04.16;63440;61727;1713;0;DPS
29.04.16;51345;50489;856;0;DPS
30.04.16;31255;30774;481;0;DPS
02.05.16;82150;80885;1265;0;DPS
03.05.16;55460;54438;1022;0;DPS
04.05.16;66868;65464;1404;0;DPS
05.05.16;14586;14276;310;0;DPS
07.05.16;67182;65927;1255;0;DPS
09.05.16;77466;76366;1100;0;DPS
10.05.16;62172;61175;997;0;DPS
11.05.16;57596;56554;1042;0;DPS
12.05.16;71824;70454;1370;0;DPS
13.05.16;61093;60145;948;0;DPS
14.05.16;28135;27555;580;0;DPS
17.05.16;71429;70125;1304;0;DPS
18.05.16;53746;52757;989;0;DPS
19.05.16;70718;69495;1223;0;DPS
20.05.16;55199;54266;933;0;DPS
21.05.16;35678;35125;553;0;DPS
23.05.16;90061;88070;1991;0;DPS
24.05.16;46507;45808;699;0;DPS
25.05.16;44889;44003;886;0;DPS
26.05.16;66503;64817;1686;0;DPS
27.05.16;51379;50279;1100;0;DPS
28.05.16;28783;28241;542;0;DPS
30.05.16;74815;73668;1147;0;DPS
31.05.16;46840;46153;687;0;DPS
01.06.16;52392;51387;1005;0;DPS
02.06.16;68718;67330;1388;0;DPS
03.06.16;54243;53440;803;0;DPS
04.06.16;30506;30053;453;0;DPS
06.06.16;86620;84892;1728;0;DPS
07.06.16;60950;60014;936;0;DPS
08.06.16;53293;52491;802;0;DPS
09.06.16;67759;66702;1057;0;DPS
10.06.16;59284;53440;5844;0;DPS
11.06.16;33554;31343;2211;0;DPS
13.06.16;71852;70746;1106;0;DPS
14.06.16;49657;48760;897;0;DPS
15.06.16;48502;47375;1127;0;DPS
16.06.16;59962;58961;1001;0;DPS
17.06.16;50403;49687;716;0;DPS
18.06.16;30122;29676;446;0;DPS
20.06.16;74494;73388;1106;0;DPS
21.06.16;56042;55385;657;0;DPS
22.06.16;49888;49133;755;0;DPS
23.06.16;59935;59223;712;0;DPS
24.06.16;47235;46607;628;0;DPS
25.06.16;26517;26170;347;0;DPS
27.06.16;66822;65901;921;0;DPS
28.06.16;45204;44488;716;0;DPS
29.06.16;48457;47065;1392;0;DPS
30.06.16;59955;59071;884;0;DPS
01.07.16;52027;51374;653;0;DPS
02.07.16;28225;27840;385;0;DPS
04.07.16;75117;73524;1593;0;DPS
05.07.16;54895;53815;1080;0;DPS
06.07.16;46025;45127;898;0;DPS
07.07.16;58346;57532;814;0;DPS
08.07.16;50240;49601;639;0;DPS
09.07.16;31254;30777;477;0;DPS
11.07.16;70285;69277;1008;0;DPS
12.07.16;50459;49764;695;0;DPS
13.07.16;51619;50817;802;0;DPS
14.07.16;63429;62623;806;0;DPS
15.07.16;50755;49982;773;0;DPS
16.07.16;32320;31727;593;0;DPS
18.07.16;76173;75152;1021;0;DPS
19.07.16;61806;61075;731;0;DPS
20.07.16;52184;51180;1004;0;DPS
21.07.16;65750;64691;1059;0;DPS
22.07.16;50542;49917;625;0;DPS
23.07.16;32108;31631;477;0;DPS
25.07.16;73601;72683;918;0;DPS
26.07.16;53638;52836;802;0;DPS
27.07.16;48979;48120;859;0;DPS
28.07.16;63303;62231;1072;0;DPS
29.07.16;56877;56230;647;0;DPS
30.07.16;31757;30943;814;0;DPS
01.08.16;77410;76046;1364;0;DPS
02.08.16;60783;59765;1018;0;DPS
03.08.16;53058;52255;803;0;DPS
04.08.16;63912;62717;1195;0;DPS
05.08.16;49701;48885;816;0;DPS
06.08.16;22330;21928;402;0;DPS
08.08.16;79585;78422;1163;0;DPS
09.08.16;52308;51414;894;0;DPS
10.08.16;46604;45722;882;0;DPS
11.08.16;58428;57124;1304;0;DPS
12.08.16;48232;47559;673;0;DPS
13.08.16;31938;31553;385;0;DPS
15.08.16;76066;73568;2498;0;DPS
16.08.16;58851;55838;3013;0;DPS
17.08.16;45207;44264;943;0;DPS
18.08.16;56399;55083;1316;0;DPS
19.08.16;46296;45269;1027;0;DPS
20.08.16;29443;28937;506;0;DPS
22.08.16;61601;60598;1003;0;DPS
23.08.16;48115;47224;891;0;DPS
24.08.16;47175;45877;1298;0;DPS
25.08.16;57769;56789;980;0;DPS
26.08.16;43063;42350;713;0;DPS
27.08.16;28934;28506;428;0;DPS
29.08.16;69205;68019;1186;0;DPS
30.08.16;63988;62761;1227;0;DPS
31.08.16;51915;50511;1404;0;DPS
01.09.16;67609;66362;1247;0;DPS
02.09.16;55874;54953;921;0;DPS
03.09.16;34355;33551;804;0;DPS
05.09.16;79574;78329;1245;0;DPS
06.09.16;57381;56374;1007;0;DPS
07.09.16;54444;53156;1288;0;DPS
08.09.16;63527;62328;1199;0;DPS
09.09.16;49220;48345;875;0;DPS
10.09.16;30354;29742;612;0;DPS
12.09.16;74888;73320;1568;0;DPS
13.09.16;67488;56902;10586;0;DPS
14.09.16;44836;44022;814;0;DPS
15.09.16;59822;58918;904;0;DPS
16.09.16;51312;50493;819;0;DPS
17.09.16;31683;30880;803;0;DPS
19.09.16;71376;70183;1193;0;DPS
20.09.16;52479;51002;1477;0;DPS
21.09.16;48534;46879;1655;0;DPS
22.09.16;63986;63032;954;0;DPS
23.09.16;54205;53500;705;0;DPS
24.09.16;26878;26272;606;0;DPS
26.09.16;81226;79613;1613;0;DPS
27.09.16;60517;59567;950;0;DPS
28.09.16;51547;49726;1821;0;DPS
29.09.16;60258;58865;1393;0;DPS
30.09.16;49056;48166;890;0;DPS
01.10.16;56402;55229;1173;0;DPS
04.10.16;58137;56923;1214;0;DPS
05.10.16;60733;58774;1959;0;DPS
06.10.16;81059;79634;1425;0;DPS
07.10.16;60737;59511;1226;0;DPS
08.10.16;37642;36790;852;0;DPS
10.10.16;85085;83647;1438;0;DPS
11.10.16;64458;63378;1080;0;DPS
12.10.16;48881;47880;1001;0;DPS
13.10.16;63447;60434;3013;0;DPS
14.10.16;47934;47012;922;0;DPS
15.10.16;25272;24842;430;0;DPS
17.10.16;68854;67401;1453;0;DPS
18.10.16;50776;49485;1291;0;DPS
19.10.16;54186;52628;1558;0;DPS
20.10.16;63041;60893;2148;0;DPS
21.10.16;55801;53898;1903;0;DPS
22.10.16;33974;32320;1654;0;DPS
24.10.16;79551;77240;2311;0;DPS
25.10.16;69302;67407;1895;0;DPS
26.10.16;59506;55330;4176;0;DPS
27.10.16;59321;57473;1848;0;DPS
28.10.16;54090;52551;1539;0;DPS
29.10.16;36729;35942;787;0;DPS
31.10.16;70458;68247;2211;0;DPS
01.11.16;59212;56689;2523;0;DPS
02.11.16;57862;55674;2188;0;DPS
03.11.16;68111;65828;2283;0;DPS
04.11.16;57874;56442;1432;0;DPS
05.11.16;40468;39277;1191;0;DPS
07.11.16;85579;83312;2267;0;DPS
08.11.16;70229;68820;1409;0;DPS
09.11.16;55852;54465;1387;0;DPS
10.11.16;63730;62341;1389;0;DPS
11.11.16;50727;49745;982;0;DPS
12.11.16;33954;33329;625;0;DPS
14.11.16;67918;66357;1561;0;DPS
15.11.16;51255;49818;1437;0;DPS
16.11.16;54894;53352;1542;0;DPS
17.11.16;69125;66141;2984;0;DPS
18.11.16;52063;50937;1126;0;DPS
19.11.16;33206;32112;1094;0;DPS
21.11.16;80509;78796;1713;0;DPS
22.11.16;72547;70532;2015;0;DPS
23.11.16;58043;55559;2484;0;DPS
24.11.16;61258;59602;1656;0;DPS
25.11.16;63024;60590;2434;0;DPS
26.11.16;61636;60108;1528;0;DPS
28.11.16;62451;61263;1188;0;DPS
29.11.16;69208;67805;1403;0;DPS
30.11.16;72436;71098;1338;0;DPS
01.12.16;76501;74716;1785;0;DPS
02.12.16;67487;66486;1001;0;DPS
03.12.16;71217;70275;942;0;DPS
05.12.16;76793;75603;1190;0;DPS
06.12.16;78254;77184;1070;0;DPS
07.12.16;65216;64396;820;0;DPS
08.12.16;58670;57526;1144;0;DPS
09.12.16;64105;63396;709;0;DPS
10.12.16;64338;63261;1077;0;DPS
12.12.16;60274;57425;2849;0;DPS
13.12.16;66071;64738;1333;0;DPS
14.12.16;60274;59131;1143;0;DPS
15.12.16;65083;64052;1031;0;DPS
16.12.16;66728;65665;1063;0;DPS
17.12.16;66178;65175;1003;0;DPS
19.12.16;64183;62880;1303;0;DPS
20.12.16;72530;71095;1435;0;DPS
21.12.16;73895;72777;1118;0;DPS
22.12.16;82614;81310;1304;0;DPS
23.12.16;72772;71845;927;0;DPS
24.12.16;46260;45467;793;0;DPS
27.12.16;86312;85126;1186;0;DPS
28.12.16;71563;69385;2178;0;DPS
29.12.16;63341;62617;724;0;DPS
30.12.16;51214;50561;653;0;DPS
31.12.16;40826;40346;480;0;DPS
02.01.17;59373;58653;720;0;DPS
03.01.17;43327;42914;413;0;DPS
04.01.17;39787;39183;604;0;DPS
05.01.17;52337;51140;1197;0;DPS
06.01.17;48381;47628;753;0;DPS
07.01.17;30247;29495;752;0;DPS
09.01.17;67167;65652;1515;0;DPS
10.01.17;52130;50863;1267;0;DPS
11.01.17;52480;51354;1126;0;DPS
12.01.17;56885;55213;1672;0;DPS
13.01.17;48139;47593;546;0;DPS
14.01.17;30193;29415;778;0;DPS
16.01.17;65567;64871;696;0;DPS
17.01.17;46399;45771;628;0;DPS
18.01.17;57445;56730;715;0;DPS
19.01.17;57944;57100;844;0;DPS
20.01.17;48015;47473;542;0;DPS
21.01.17;29974;29349;625;0;DPS
23.01.17;71895;71010;885;0;DPS
24.01.17;54578;53864;714;0;DPS
25.01.17;49665;48984;681;0;DPS
26.01.17;56785;56026;759;0;DPS
27.01.17;50286;49753;533;0;DPS
28.01.17;35366;34846;520;0;DPS
30.01.17;73550;72712;838;0;DPS
31.01.17;49932;49428;504;0;DPS
01.02.17;53964;53256;708;0;DPS
02.02.17;62169;61106;1063;0;DPS
03.02.17;58955;58131;824;0;DPS
04.02.17;39849;39333;516;0;DPS
06.02.17;82523;81526;997;0;DPS
07.02.17;56956;55805;1151;0;DPS
08.02.17;56042;54820;1222;0;DPS
09.02.17;60357;59485;872;0;DPS
10.02.17;66344;52984;13360;0;DPS
11.02.17;31296;30655;641;0;DPS
13.02.17;78732;67326;11406;0;DPS
14.02.17;49788;49160;628;0;DPS
15.02.17;56517;55322;1195;0;DPS
16.02.17;61719;61015;704;0;DPS
17.02.17;52535;51986;549;0;DPS
18.02.17;35541;34584;957;0;DPS
20.02.17;76771;75749;1022;0;DPS
21.02.17;51217;50653;564;0;DPS
22.02.17;57419;56450;969;0;DPS
23.02.17;63419;62624;795;0;DPS
24.02.17;52380;51726;654;0;DPS
25.02.17;34285;33834;451;0;DPS
27.02.17;77907;77024;883;0;DPS
28.02.17;52166;50913;1253;0;DPS
01.03.17;59208;58111;1097;0;DPS
02.03.17;66669;65836;833;0;DPS
03.03.17;61030;60045;985;0;DPS
04.03.17;37812;36757;1055;0;DPS
06.03.17;87110;85514;1596;0;DPS
07.03.17;63073;62146;927;0;DPS
08.03.17;59020;58165;855;0;DPS
09.03.17;65416;63889;1527;0;DPS
10.03.17;58402;57830;572;0;DPS
11.03.17;33758;33199;559;0;DPS
13.03.17;73414;72089;1325;0;DPS
14.03.17;46892;46301;591;0;DPS
15.03.17;56750;56022;728;0;DPS
16.03.17;71576;59629;11947;0;DPS
17.03.17;53790;51645;2145;0;DPS
18.03.17;30295;29767;528;0;DPS
20.03.17;73819;72715;1104;0;DPS
21.03.17;59229;56122;3107;0;DPS
22.03.17;53220;51298;1922;0;DPS
23.03.17;58520;57114;1406;0;DPS
24.03.17;52513;51704;809;0;DPS
25.03.17;31720;31180;540;0;DPS
27.03.17;71030;67847;3183;0;DPS
28.03.17;52077;51143;934;0;DPS
29.03.17;56541;55797;744;0;DPS
30.03.17;63078;62386;692;0;DPS
31.03.17;55336;54695;641;0;DPS
01.04.17;38232;37002;1230;0;DPS
03.04.17;88469;83021;5448;0;DPS
04.04.17;67999;66927;1072;0;DPS
05.04.17;60269;58942;1327;0;DPS
06.04.17;69749;68851;898;0;DPS
07.04.17;54222;53647;575;0;DPS
08.04.17;54435;53663;772;0;DPS
10.04.17;64363;63614;749;0;DPS
11.04.17;66108;65315;793;0;DPS
12.04.17;68327;66965;1362;0;DPS
13.04.17;67110;66225;885;0;DPS
14.04.17;68216;67056;1160;0;DPS
18.04.17;68859;68109;750;0;DPS
19.04.17;52408;51753;655;0;DPS
20.04.17;81383;80275;1108;0;DPS
21.04.17;66844;65816;1028;0;DPS
22.04.17;39245;37581;1664;0;DPS
24.04.17;78254;77267;987;0;DPS
25.04.17;55031;54475;556;0;DPS
26.04.17;56327;54657;1670;0;DPS
27.04.17;53797;53199;598;0;DPS
28.04.17;53027;52383;644;0;DPS
29.04.17;53586;52644;942;0;DPS
02.05.17;71340;70474;866;0;DPS
03.05.17;53555;52805;750;0;DPS
04.05.17;83833;82362;1471;0;DPS
05.05.17;66640;65884;756;0;DPS
06.05.17;31934;31350;584;0;DPS
08.05.17;82094;81050;1044;0;DPS
09.05.17;56332;55755;577;0;DPS
10.05.17;55513;54822;691;0;DPS
11.05.17;66055;64865;1190;0;DPS
12.05.17;49642;49236;406;0;DPS
13.05.17;36806;36304;502;0;DPS
15.05.17;81174;80089;1085;0;DPS
16.05.17;59330;58647;683;0;DPS
17.05.17;50159;49508;651;0;DPS
18.05.17;63668;63075;593;0;DPS
19.05.17;52583;51821;762;0;DPS
20.05.17;38407;37802;605;0;DPS
22.05.17;73223;72378;845;0;DPS
23.05.17;59005;58188;817;0;DPS
24.05.17;63929;62772;1157;0;DPS
25.05.17;54952;54117;835;0;DPS
27.05.17;60443;59353;1090;0;DPS
29.05.17;71338;70512;826;0;DPS
30.05.17;63996;63457;539;0;DPS
31.05.17;59013;57583;1430;0;DPS
01.06.17;61707;60726;981;0;DPS
02.06.17;68924;68166;758;0;DPS
03.06.17;44717;43990;727;0;DPS
06.06.17;59486;58982;504;0;DPS
07.06.17;58025;57289;736;0;DPS
08.06.17;74467;73247;1220;0;DPS
09.06.17;67190;66396;794;0;DPS
10.06.17;35546;34910;636;0;DPS
12.06.17;85094;83964;1130;0;DPS
13.06.17;68432;67808;624;0;DPS
14.06.17;54885;54342;543;0;DPS
15.06.17;61696;60931;765;0;DPS
16.06.17;49067;48585;482;0;DPS
17.06.17;33905;33463;442;0;DPS
19.06.17;73156;72287;869;0;DPS
20.06.17;45614;44848;766;0;DPS
21.06.17;54597;53742;855;0;DPS
22.06.17;62696;61599;1097;0;DPS
23.06.17;48579;48038;541;0;DPS
24.06.17;32127;31668;459;0;DPS
26.06.17;77503;76542;961;0;DPS
27.06.17;55840;55003;837;0;DPS
28.06.17;59472;58087;1385;0;DPS
29.06.17;62529;61798;731;0;DPS
30.06.17;52284;51699;585;0;DPS
01.07.17;39549;38910;639;0;DPS
03.07.17;76162;75075;1087;0;DPS
04.07.17;55805;55176;629;0;DPS
05.07.17;61490;60438;1052;0;DPS
06.07.17;67034;65779;1255;0;DPS
07.07.17;47596;47007;589;0;DPS
08.07.17;40749;32613;8136;0;DPS
10.07.17;75219;74129;1090;0;DPS
11.07.17;55242;54605;637;0;DPS
12.07.17;57451;56304;1147;0;DPS
13.07.17;64191;62831;1360;0;DPS
14.07.17;51897;51165;732;0;DPS
15.07.17;42585;41942;643;0;DPS
17.07.17;83936;82950;986;0;DPS
18.07.17;55073;54354;719;0;DPS
19.07.17;64530;63341;1189;0;DPS
20.07.17;67288;66143;1145;0;DPS
21.07.17;54222;53467;755;0;DPS
22.07.17;33139;31438;1701;0;DPS
24.07.17;82614;81213;1401;0;DPS
25.07.17;57549;56050;1499;0;DPS
26.07.17;49495;48568;927;0;DPS
27.07.17;56833;55674;1159;0;DPS
28.07.17;48533;47735;798;0;DPS
29.07.17;39749;38893;856;0;DPS
31.07.17;69653;68663;990;0;DPS
01.08.17;50732;49981;751;0;DPS
02.08.17;51823;50751;1072;0;DPS
03.08.17;60139;58909;1230;0;DPS
04.08.17;54763;54141;622;0;DPS
05.08.17;38960;38380;580;0;DPS
07.08.17;72790;71529;1261;0;DPS
08.08.17;58799;57875;924;0;DPS
09.08.17;50663;49845;818;0;DPS
10.08.17;58868;57859;1009;0;DPS
11.08.17;52586;51544;1042;0;DPS
12.08.17;36399;35657;742;0;DPS
14.08.17;62297;61108;1189;0;DPS
15.08.17;44790;44040;750;0;DPS
16.08.17;55955;54970;985;0;DPS
17.08.17;57508;56382;1126;0;DPS
18.08.17;50927;49907;1020;0;DPS
19.08.17;41349;40540;809;0;DPS
21.08.17;74486;72857;1629;0;DPS
22.08.17;56284;54663;1621;0;DPS
23.08.17;50741;48952;1789;0;DPS
24.08.17;60901;59630;1271;0;DPS
25.08.17;45951;45020;931;0;DPS
28.08.17;62582;61170;1412;0;DPS
29.08.17;51144;50156;988;0;DPS
30.08.17;61354;55918;5436;0;DPS
31.08.17;59176;58050;1126;0;DPS
01.09.17;52944;51892;1052;0;DPS
02.09.17;43185;42120;1065;0;DPS
04.09.17;84285;82690;1595;0;DPS
05.09.17;63761;62468;1293;0;DPS
06.09.17;56623;55415;1208;0;DPS
07.09.17;62293;61310;983;0;DPS
08.09.17;53143;52323;820;0;DPS
09.09.17;44359;43666;693;0;DPS
11.09.17;77601;76419;1182;0;DPS
12.09.17;48280;46543;1737;0;DPS
13.09.17;56325;54071;2254;0;DPS
14.09.17;62621;60871;1750;0;DPS
15.09.17;50441;49202;1239;0;DPS
16.09.17;37947;37009;938;0;DPS
18.09.17;78125;76353;1772;0;DPS
19.09.17;59211;57068;2143;0;DPS
20.09.17;50184;48906;1278;0;DPS
21.09.17;59796;58495;1301;0;DPS
22.09.17;50114;49094;1020;0;DPS
23.09.17;42942;41972;970;0;DPS
25.09.17;67078;65871;1207;0;DPS
26.09.17;45473;44555;918;0;DPS
27.09.17;54220;52466;1754;0;DPS
28.09.17;52767;51308;1459;0;DPS
29.09.17;58086;56757;1329;0;DPS
30.09.17;59649;58158;1491;0;DPS
02.10.17;70931;69430;1501;0;DPS
03.10.17;62936;61092;1844;0;DPS
05.10.17;63056;61618;1438;0;DPS
06.10.17;56054;54624;1430;0;DPS
07.10.17;42762;41376;1386;0;DPS
09.10.17;78567;76632;1935;0;DPS
10.10.17;53965;52428;1537;0;DPS
11.10.17;61586;59819;1767;0;DPS
12.10.17;64188;62615;1573;0;DPS
13.10.17;49412;48478;934;0;DPS
14.10.17;34657;33474;1183;0;DPS
16.10.17;78534;76638;1896;0;DPS
17.10.17;58642;56055;2587;0;DPS
18.10.17;63237;60043;3194;0;DPS
19.10.17;65906;64136;1770;0;DPS
20.10.17;51683;50316;1367;0;DPS
21.10.17;30970;27422;3548;0;DPS
23.10.17;66668;64872;1796;0;DPS
24.10.17;52540;50201;2339;0;DPS
25.10.17;58988;54844;4144;0;DPS
26.10.17;54580;52169;2411;0;DPS
27.10.17;50456;49142;1314;0;DPS
28.10.17;58473;56502;1971;0;DPS
30.10.17;73617;71979;1638;0;DPS
31.10.17;78932;74896;4036;0;DPS
02.11.17;79795;76337;3458;0;DPS
03.11.17;71959;70136;1823;0;DPS
04.11.17;57442;55712;1730;0;DPS
06.11.17;81676;79297;2379;0;DPS
07.11.17;64464;63022;1442;0;DPS
08.11.17;78818;75963;2855;0;DPS
09.11.17;76207;74093;2114;0;DPS
10.11.17;58534;57213;1321;0;DPS
11.11.17;42627;40907;1720;0;DPS
13.11.17;82803;79930;2873;0;DPS
14.11.17;66387;64533;1854;0;DPS
15.11.17;63566;61149;2417;0;DPS
16.11.17;69517;67858;1659;0;DPS
17.11.17;57824;56383;1441;0;DPS
18.11.17;43274;41494;1780;0;DPS
20.11.17;79520;77664;1856;0;DPS
21.11.17;56029;54835;1194;0;DPS
22.11.17;66717;65137;1580;0;DPS
23.11.17;74092;72658;1434;0;DPS
24.11.17;57782;56541;1241;0;DPS
25.11.17;53567;51986;1581;0;DPS
27.11.17;84117;82523;1594;0;DPS
28.11.17;67881;66230;1651;0;DPS
29.11.17;63549;61925;1624;0;DPS
30.11.17;72586;69930;2656;0;DPS
01.12.17;66794;65680;1114;0;DPS
02.12.17;73075;71827;1248;0;DPS
04.12.17;72148;71058;1090;0;DPS
05.12.17;61584;59427;2157;0;DPS
06.12.17;70180;68729;1451;0;DPS
07.12.17;68542;67541;1001;0;DPS
08.12.17;57667;56746;921;0;DPS
09.12.17;60078;58974;1104;0;DPS
11.12.17;69171;67210;1961;0;DPS
12.12.17;61593;60592;1001;0;DPS
13.12.17;58522;56567;1955;0;DPS
14.12.17;62856;61963;893;0;DPS
15.12.17;60312;59243;1069;0;DPS
16.12.17;68013;66595;1418;0;DPS
18.12.17;69272;68278;994;0;DPS
19.12.17;68465;64414;4051;0;DPS
20.12.17;70698;69193;1505;0;DPS
21.12.17;78848;75500;3348;0;DPS
22.12.17;74892;73798;1094;0;DPS
23.12.17;95968;94115;1853;0;DPS
27.12.17;79106;78111;995;0;DPS
28.12.17;46643;45911;732;0;DPS
29.12.17;78285;68370;9915;0;DPS
30.12.17;77093;75396;1697;0;DPS
02.01.18;66139;65150;989;0;DPS
03.01.18;57852;57122;730;0;DPS
04.01.18;56013;54823;1190;0;DPS
05.01.18;46481;45676;805;0;DPS
06.01.18;35258;34590;668;0;DPS
08.01.18;66787;65493;1294;0;DPS
09.01.18;49984;49015;969;0;DPS
10.01.18;45235;43948;1287;0;DPS
11.01.18;53628;52486;1142;0;DPS
12.01.18;41027;40397;630;0;DPS
13.01.18;31519;30990;529;0;DPS
15.01.18;59933;59005;928;0;DPS
16.01.18;44824;44160;664;0;DPS
17.01.18;47324;46523;801;0;DPS
18.01.18;52793;52061;732;0;DPS
19.01.18;38633;38143;490;0;DPS
20.01.18;36512;31147;5365;0;DPS
22.01.18;64958;63842;1116;0;DPS
23.01.18;47497;46816;681;0;DPS
24.01.18;42527;41611;916;0;DPS
25.01.18;50667;49752;915;0;DPS
26.01.18;41561;40938;623;0;DPS
27.01.18;34500;33555;945;0;DPS
29.01.18;59748;58429;1319;0;DPS
30.01.18;43518;42669;849;0;DPS
31.01.18;47689;46733;956;0;DPS
01.02.18;52839;52046;793;0;DPS
02.02.18;49052;48381;671;0;DPS
03.02.18;40122;39440;682;0;DPS
05.02.18;72615;71294;1321;0;DPS
06.02.18;51890;50995;895;0;DPS
07.02.18;51120;48771;2349;0;DPS
08.02.18;56031;55029;1002;0;DPS
09.02.18;46771;45821;950;0;DPS
10.02.18;32753;32130;623;0;DPS
12.02.18;64982;64062;920;0;DPS
13.02.18;44552;44010;542;0;DPS
14.02.18;49509;48746;763;0;DPS
15.02.18;58373;57676;697;0;DPS
16.02.18;46167;45602;565;0;DPS
17.02.18;35888;35191;697;0;DPS
19.02.18;68465;67395;1070;0;DPS
20.02.18;49688;48801;887;0;DPS
21.02.18;49543;48641;902;0;DPS
22.02.18;59869;58249;1620;0;DPS
23.02.18;48071;46728;1343;0;DPS
24.02.18;54880;34420;20460;0;DPS
26.02.18;66639;65474;1165;0;DPS
27.02.18;45121;44189;932;0;DPS
28.02.18;47981;47025;956;0;DPS
01.03.18;58798;57644;1154;0;DPS
02.03.18;49692;48757;935;0;DPS
03.03.18;44598;43690;908;0;DPS
05.03.18;77711;76387;1324;0;DPS
06.03.18;55963;55122;841;0;DPS
07.03.18;51705;50622;1083;0;DPS
08.03.18;58393;57433;960;0;DPS
09.03.18;46763;46005;758;0;DPS
10.03.18;53128;50968;2160;0;DPS
12.03.18;51842;50591;1251;0;DPS
13.03.18;48268;47273;995;0;DPS
14.03.18;54655;53689;966;0;DPS
15.03.18;73121;71920;1201;0;DPS
16.03.18;46991;46167;824;0;DPS
17.03.18;37934;36974;960;0;DPS
19.03.18;67896;66412;1484;0;DPS
20.03.18;48628;47885;743;0;DPS
21.03.18;50932;49288;1644;0;DPS
22.03.18;64248;62871;1377;0;DPS
23.03.18;52980;52148;832;0;DPS
24.03.18;39492;38682;810;0;DPS
26.03.18;58535;57218;1317;0;DPS
27.03.18;56755;55781;974;0;DPS
28.03.18;60418;59114;1304;0;DPS
29.03.18;53656;52650;1006;0;DPS
30.03.18;52061;50927;1134;0;DPS
31.03.18;18044;17669;375;0;DPS
03.04.18;56257;55201;1056;0;DPS
04.04.18;54633;52922;1711;0;DPS
05.04.18;81623;80221;1402;0;DPS
06.04.18;64181;62529;1652;0;DPS
07.04.18;74108;72404;1704;0;DPS
09.04.18;54733;53704;1029;0;DPS
10.04.18;43808;42809;999;0;DPS
11.04.18;47266;45641;1625;0;DPS
12.04.18;63140;61926;1214;0;DPS
13.04.18;46669;45858;811;0;DPS
14.04.18;38147;37398;749;0;DPS
16.04.18;66937;64799;2138;0;DPS
17.04.18;53931;48905;5026;0;DPS
18.04.18;54107;51614;2493;0;DPS
19.04.18;66154;64715;1439;0;DPS
20.04.18;44329;43458;871;0;DPS
21.04.18;36186;35519;667;0;DPS
23.04.18;61001;59949;1052;0;DPS
24.04.18;54608;53275;1333;0;DPS
25.04.18;64465;62739;1726;0;DPS
26.04.18;69795;68724;1071;0;DPS
27.04.18;46252;45503;749;0;DPS
28.04.18;49350;48494;856;0;DPS
01.05.18;41695;40942;753;0;DPS
03.05.18;110560;108609;1951;0;DPS
04.05.18;46435;45732;703;0;DPS
05.05.18;80003;78267;1736;0;DPS
07.05.18;63636;61246;2390;0;DPS
08.05.18;75278;72402;2876;0;DPS
09.05.18;69544;67936;1608;0;DPS
11.05.18;47666;46407;1259;0;DPS
12.05.18;57842;56502;1340;0;DPS
14.05.18;68150;66951;1199;0;DPS
15.05.18;55578;54700;878;0;DPS
16.05.18;54123;52698;1425;0;DPS
17.05.18;67939;65677;2262;0;DPS
18.05.18;51509;50669;840;0;DPS
19.05.18;58407;57282;1125;0;DPS
22.05.18;45479;44529;950;0;DPS
23.05.18;46235;45284;951;0;DPS
24.05.18;73391;72086;1305;0;DPS
25.05.18;56601;55616;985;0;DPS
26.05.18;45826;45031;795;0;DPS
28.05.18;75725;73863;1862;0;DPS
29.05.18;51482;50051;1431;0;DPS
30.05.18;53239;48142;5097;0;DPS
31.05.18;64206;61331;2875;0;DPS
01.06.18;46667;45723;944;0;DPS
02.06.18;39756;38578;1178;0;DPS
04.06.18;66855;65187;1668;0;DPS
05.06.18;47345;46385;960;0;DPS
06.06.18;54022;51738;2284;0;DPS
07.06.18;60741;59428;1313;0;DPS
08.06.18;46172;45226;946;0;DPS
09.06.18;34494;33650;844;0;DPS
11.06.18;64409;63364;1045;0;DPS
12.06.18;46694;45399;1295;0;DPS
13.06.18;50847;49860;987;0;DPS
14.06.18;63991;62781;1210;0;DPS
15.06.18;48415;47559;856;0;DPS
16.06.18;29632;29148;484;0;DPS
18.06.18;57316;56348;968;0;DPS
19.06.18;45141;44329;812;0;DPS
20.06.18;53042;51786;1256;0;DPS
21.06.18;59824;58801;1023;0;DPS
22.06.18;41644;40941;703;0;DPS
23.06.18;36113;35413;700;0;DPS
25.06.18;70333;69046;1287;0;DPS
26.06.18;46344;45606;738;0;DPS
27.06.18;46104;44846;1258;0;DPS
28.06.18;63583;61682;1901;0;DPS
29.06.18;60504;59531;973;0;DPS
30.06.18;31309;30475;834;0;DPS
02.07.18;75631;74489;1142;0;DPS
03.07.18;54240;53396;844;0;DPS
04.07.18;62823;61685;1138;0;DPS
05.07.18;76927;73728;3199;0;DPS
06.07.18;66207;65036;1171;0;DPS
07.07.18;28338;27615;723;0;DPS
09.07.18;76567;75370;1197;0;DPS
10.07.18;52843;51515;1328;0;DPS
11.07.18;49044;48106;938;0;DPS
12.07.18;63572;62291;1281;0;DPS
13.07.18;58125;57121;1004;0;DPS
14.07.18;23097;22661;436;0;DPS
16.07.18;57987;56896;1091;0;DPS
17.07.18;43779;42603;1176;0;DPS
18.07.18;50542;49143;1399;0;DPS
19.07.18;59729;58734;995;0;DPS
20.07.18;43362;42479;883;0;DPS
21.07.18;36262;35549;713;0;DPS
23.07.18;63209;62009;1200;0;DPS
24.07.18;44581;43724;857;0;DPS
25.07.18;46690;45515;1175;0;DPS
26.07.18;55070;54159;911;0;DPS
27.07.18;38270;37420;850;0;DPS
28.07.18;36072;35449;623;0;DPS
30.07.18;54973;53974;999;0;DPS
31.07.18;42866;41292;1574;0;DPS
01.08.18;54068;50981;3087;0;DPS
02.08.18;65275;63411;1864;0;DPS
03.08.18;42758;42038;720;0;DPS
04.08.18;44511;43740;771;0;DPS
06.08.18;70918;69810;1108;0;DPS
07.08.18;47694;46922;772;0;DPS
08.08.18;43939;42691;1248;0;DPS
09.08.18;60116;59054;1062;0;DPS
10.08.18;42837;42112;725;0;DPS
11.08.18;34664;33909;755;0;DPS
13.08.18;56205;53112;3093;0;DPS
14.08.18;46411;45168;1243;0;DPS
15.08.18;53783;52613;1170;0;DPS
16.08.18;70333;66019;4314;0;DPS
17.08.18;45134;44409;725;0;DPS
18.08.18;36144;35457;687;0;DPS
20.08.18;65773;64350;1423;0;DPS
21.08.18;46382;45069;1313;0;DPS
22.08.18;52989;51426;1563;0;DPS
23.08.18;59983;58801;1182;0;DPS
24.08.18;44192;42272;1920;0;DPS
25.08.18;34211;33503;708;0;DPS
27.08.18;56575;55554;1021;0;DPS
28.08.18;44000;43309;691;0;DPS
29.08.18;48982;47687;1295;0;DPS
30.08.18;60011;59111;900;0;DPS
31.08.18;45377;44509;868;0;DPS
01.09.18;38939;38098;841;0;DPS
03.09.18;72161;70913;1248;0;DPS
04.09.18;50274;49092;1182;0;DPS
05.09.18;53471;52121;1350;0;DPS
06.09.18;64695;63703;992;0;DPS
07.09.18;44181;43463;718;0;DPS
08.09.18;35836;34918;918;0;DPS
10.09.18;63422;59875;3547;0;DPS
11.09.18;43605;42789;816;0;DPS
12.09.18;51952;50998;954;0;DPS
13.09.18;58794;57770;1024;0;DPS
14.09.18;44622;43712;910;0;DPS
15.09.18;34738;33843;895;0;DPS
17.09.18;66104;64471;1633;0;DPS
18.09.18;47403;45033;2370;0;DPS
19.09.18;52966;51940;1026;0;DPS
20.09.18;65608;64502;1106;0;DPS
21.09.18;44005;43106;899;0;DPS
22.09.18;33825;33061;764;0;DPS
24.09.18;57170;55977;1193;0;DPS
25.09.18;46128;44981;1147;0;DPS
26.09.18;60094;58491;1603;0;DPS
27.09.18;49787;48621;1166;0;DPS
28.09.18;42148;41142;1006;0;DPS
29.09.18;55443;53990;1453;0;DPS
01.10.18;61613;60585;1028;0;DPS
02.10.18;50372;47988;2384;0;DPS
03.10.18;16006;15615;391;0;DPS
04.10.18;47889;46556;1333;0;DPS
05.10.18;62189;60892;1297;0;DPS
06.10.18;67177;65685;1492;0;DPS
08.10.18;56392;55234;1158;0;DPS
09.10.18;43856;41992;1864;0;DPS
10.10.18;56853;54851;2002;0;DPS
11.10.18;66263;64481;1782;0;DPS
12.10.18;44229;43184;1045;0;DPS
13.10.18;38132;36674;1458;0;DPS
15.10.18;60885;59020;1865;0;DPS
16.10.18;44852;40047;4805;0;DPS
17.10.18;44308;42158;2150;0;DPS
18.10.18;69257;65044;4213;0;DPS
19.10.18;42110;40870;1240;0;DPS
20.10.18;38927;37302;1625;0;DPS
22.10.18;69981;67481;2500;0;DPS
23.10.18;54992;49617;5375;0;DPS
24.10.18;68423;63189;5234;0;DPS
25.10.18;58603;56503;2100;0;DPS
26.10.18;41349;40696;653;0;DPS
27.10.18;66138;59660;6478;0;DPS
29.10.18;77550;75036;2514;0;DPS
30.10.18;57166;55780;1386;0;DPS
31.10.18;22310;21990;320;0;DPS
01.11.18;53456;51553;1903;0;DPS
02.11.18;55468;53658;1810;0;DPS
03.11.18;62254;60684;1570;0;DPS
05.11.18;63968;62266;1702;0;DPS
06.11.18;55171;53644;1527;0;DPS
07.11.18;65463;62489;2974;0;DPS
08.11.18;69061;65822;3239;0;DPS
09.11.18;50242;48228;2014;0;DPS
10.11.18;40248;38777;1471;0;DPS
12.11.18;71850;70172;1678;0;DPS
13.11.18;50038;48549;1489;0;DPS
14.11.18;66462;64849;1613;0;DPS
15.11.18;68511;66543;1968;0;DPS
16.11.18;48945;46459;2486;0;DPS
17.11.18;39199;37341;1858;0;DPS
19.11.18;66517;64297;2220;0;DPS
20.11.18;55546;53843;1703;0;DPS
21.11.18;66696;62718;3978;0;DPS
22.11.18;76482;72599;3883;0;DPS
23.11.18;50391;49070;1321;0;DPS
24.11.18;48101;43006;5095;0;DPS
26.11.18;90564;84774;5790;0;DPS
27.11.18;65509;61663;3846;0;DPS
28.11.18;66276;64224;2052;0;DPS
29.11.18;70315;67901;2414;0;DPS
30.11.18;75547;68105;7442;0;DPS
01.12.18;70486;68100;2386;0;DPS
03.12.18;72792;69964;2828;0;DPS
04.12.18;54317;51867;2450;0;DPS
05.12.18;64291;62551;1740;0;DPS
06.12.18;69874;67756;2118;0;DPS
07.12.18;62658;53090;9568;0;DPS
08.12.18;82058;78067;3991;0;DPS
10.12.18;64459;62841;1618;0;DPS
11.12.18;53364;51916;1448;0;DPS
12.12.18;59072;57643;1429;0;DPS
13.12.18;60898;59579;1319;0;DPS
14.12.18;48844;47490;1354;0;DPS
15.12.18;66027;64007;2020;0;DPS
17.12.18;61441;60334;1107;0;DPS
18.12.18;56638;53489;3149;0;DPS
19.12.18;63405;61559;1846;0;DPS
20.12.18;71887;70235;1652;0;DPS
21.12.18;74599;73010;1589;0;DPS
22.12.18;71496;69771;1725;0;DPS
24.12.18;72107;70371;1736;0;DPS
27.12.18;56095;55070;1025;0;DPS
28.12.18;55992;54563;1429;0;DPS
29.12.18;64411;62743;1668;0;DPS
31.12.18;68779;67386;1393;0;DPS
02.01.19;41972;40987;985;0;DPS
03.01.19;80245;77863;2382;0;DPS
04.01.19;53323;51630;1693;0;DPS
05.01.19;38692;37522;1170;0;DPS
07.01.19;58217;57102;1115;0;DPS
08.01.19;44042;42754;1288;0;DPS
09.01.19;49916;48606;1310;0;DPS
10.01.19;53722;52441;1281;0;DPS
11.01.19;38611;37692;919;0;DPS
12.01.19;29818;29153;665;0;DPS
14.01.19;50107;48877;1230;0;DPS
15.01.19;40866;39916;950;0;DPS
16.01.19;45075;43662;1413;0;DPS
17.01.19;66452;65116;1336;0;DPS
18.01.19;48351;47479;872;0;DPS
19.01.19;33558;32342;1216;0;DPS
21.01.19;51766;50322;1444;0;DPS
22.01.19;44141;43142;999;0;DPS
23.01.19;46199;44945;1254;0;DPS
24.01.19;58713;57085;1628;0;DPS
25.01.19;47714;44896;2818;0;DPS
26.01.19;35874;34940;934;0;DPS
28.01.19;56431;55312;1119;0;DPS
29.01.19;48909;47754;1155;0;DPS
30.01.19;44734;43722;1012;0;DPS
31.01.19;71343;69526;1817;0;DPS
01.02.19;51894;50631;1263;0;DPS
02.02.19;38961;37564;1397;0;DPS
04.02.19;55790;54237;1553;0;DPS
05.02.19;49137;47270;1867;0;DPS
06.02.19;52001;50747;1254;0;DPS
07.02.19;64866;63363;1503;0;DPS
08.02.19;45022;44139;883;0;DPS
09.02.19;36883;36110;773;0;DPS
11.02.19;57124;55938;1186;0;DPS
12.02.19;47068;45870;1198;0;DPS
13.02.19;48094;46883;1211;0;DPS
14.02.19;76007;72321;3686;0;DPS
15.02.19;49846;48567;1279;0;DPS
16.02.19;34283;33451;832;0;DPS
18.02.19;55590;54573;1017;0;DPS
19.02.19;51797;50686;1111;0;DPS
20.02.19;45884;44805;1079;0;DPS
21.02.19;65619;64220;1399;0;DPS
22.02.19;47311;46233;1078;0;DPS
23.02.19;34332;33620;712;0;DPS
25.02.19;53302;52094;1208;0;DPS
26.02.19;50166;46795;3371;0;DPS
27.02.19;51243;49563;1680;0;DPS
28.02.19;60047;58840;1207;0;DPS
01.03.19;48887;47915;972;0;DPS
02.03.19;39973;39094;879;0;DPS
04.03.19;63546;62361;1185;0;DPS
05.03.19;53539;52116;1423;0;DPS
06.03.19;51796;50637;1159;0;DPS
07.03.19;75104;73546;1558;0;DPS
08.03.19;57995;56925;1070;0;DPS
09.03.19;35447;34735;712;0;DPS
11.03.19;54301;53275;1026;0;DPS
12.03.19;55267;54103;1164;0;DPS
13.03.19;51193;49877;1316;0;DPS
14.03.19;65323;64012;1311;0;DPS
15.03.19;43412;42691;721;0;DPS
16.03.19;31174;30461;713;0;DPS
18.03.19;55034;53921;1113;0;DPS
19.03.19;68185;66658;1527;0;DPS
20.03.19;51559;50237;1322;0;DPS
21.03.19;58457;57372;1085;0;DPS
22.03.19;42899;42033;866;0;DPS
23.03.19;33200;32536;664;0;DPS
25.03.19;54996;54089;907;0;DPS
26.03.19;55014;53048;1966;0;DPS
27.03.19;50904;49727;1177;0;DPS
28.03.19;63283;61900;1383;0;DPS
29.03.19;49509;48541;968;0;DPS
30.03.19;35937;35058;879;0;DPS
01.04.19;60722;59040;1682;0;DPS
02.04.19;45165;44164;1001;0;DPS
03.04.19;56733;55055;1678;0;DPS
04.04.19;78512;76940;1572;0;DPS
05.04.19;56389;55385;1004;0;DPS
06.04.19;39401;38562;839;0;DPS
08.04.19;56513;55521;992;0;DPS
09.04.19;52286;51364;922;0;DPS
10.04.19;47530;46520;1010;0;DPS
11.04.19;73335;71949;1386;0;DPS
12.04.19;53180;52017;1163;0;DPS
13.04.19;38205;37476;729;0;DPS
15.04.19;57018;55875;1143;0;DPS
16.04.19;62059;60798;1261;0;DPS
17.04.19;67636;65621;2015;0;DPS
18.04.19;42246;41186;1060;0;DPS
19.04.19;36857;36000;857;0;DPS
20.04.19;32805;32083;722;0;DPS
23.04.19;60544;59602;942;0;DPS
24.04.19;46073;44664;1409;0;DPS
25.04.19;86043;83781;2262;0;DPS
26.04.19;59437;58339;1098;0;DPS
27.04.19;47540;46607;933;0;DPS
29.04.19;69156;67855;1301;0;DPS
30.04.19;57767;56324;1443;0;DPS
01.05.19;19544;19167;377;0;DPS
02.05.19;54368;53370;998;0;DPS
03.05.19;59491;52777;6714;0;DPS
04.05.19;48600;47673;927;0;DPS
06.05.19;74625;73348;1277;0;DPS
07.05.19;56781;55831;950;0;DPS
08.05.19;57202;56055;1147;0;DPS
09.05.19;69706;67952;1754;0;DPS
10.05.19;48830;46374;2456;0;DPS
11.05.19;38437;37418;1019;0;DPS
13.05.19;57180;56082;1098;0;DPS
14.05.19;52528;49515;3013;0;DPS
15.05.19;50627;49630;997;0;DPS
16.05.19;70156;68951;1205;0;DPS
17.05.19;48033;47111;922;0;DPS
18.05.19;40479;39756;723;0;DPS
20.05.19;54533;53069;1464;0;DPS
21.05.19;54316;52827;1489;0;DPS
22.05.19;48907;46679;2228;0;DPS
23.05.19;58319;57025;1294;0;DPS
24.05.19;42618;41890;728;0;DPS
25.05.19;39462;38599;863;0;DPS
27.05.19;59208;58275;933;0;DPS
28.05.19;55574;54248;1326;0;DPS
29.05.19;74871;73375;1496;0;DPS
30.05.19;20891;20453;438;0;DPS
31.05.19;36931;36388;543;0;DPS
01.06.19;44661;43690;971;0;DPS
03.06.19;70907;69555;1352;0;DPS
04.06.19;59555;58533;1022;0;DPS
05.06.19;58177;56928;1249;0;DPS
06.06.19;74541;73275;1266;0;DPS
07.06.19;70012;68757;1255;0;DPS
08.06.19;34850;34291;559;0;DPS
11.06.19;62806;61666;1140;0;DPS
12.06.19;47298;46450;848;0;DPS
13.06.19;80265;78974;1291;0;DPS
14.06.19;65483;64607;876;0;DPS
15.06.19;48736;47779;957;0;DPS
17.06.19;74954;73042;1912;0;DPS
18.06.19;57913;54728;3185;0;DPS
19.06.19;50347;49349;998;0;DPS
20.06.19;66013;64127;1886;0;DPS
21.06.19;49961;48902;1059;0;DPS
22.06.19;47490;42748;4742;0;DPS
24.06.19;68306;64324;3982;0;DPS
25.06.19;56782;54248;2534;0;DPS
26.06.19;53567;52480;1087;0;DPS
27.06.19;60805;59765;1040;0;DPS
28.06.19;49827;48920;907;0;DPS
29.06.19;44461;43677;784;0;DPS
01.07.19;68614;67153;1461;0;DPS
02.07.19;54409;53369;1040;0;DPS
03.07.19;55796;54485;1311;0;DPS
04.07.19;84888;83141;1747;0;DPS
05.07.19;53462;52035;1427;0;DPS
06.07.19;36542;35482;1060;0;DPS
08.07.19;52307;50713;1594;0;DPS
09.07.19;46959;46124;835;0;DPS
10.07.19;48708;47600;1108;0;DPS
11.07.19;60660;59626;1034;0;DPS
12.07.19;52073;51257;816;0;DPS
13.07.19;37454;36742;712;0;DPS
15.07.19;59165;58124;1041;0;DPS
16.07.19;41016;40293;723;0;DPS
17.07.19;45421;44562;859;0;DPS
18.07.19;64006;62293;1713;0;DPS
19.07.19;42513;41480;1033;0;DPS
20.07.19;31519;30835;684;0;DPS
22.07.19;47028;46294;734;0;DPS
23.07.19;42194;41375;819;0;DPS
24.07.19;52708;51409;1299;0;DPS
25.07.19;54061;52848;1213;0;DPS
26.07.19;41309;40369;940;0;DPS
27.07.19;34195;33156;1039;0;DPS
29.07.19;49605;48546;1059;0;DPS
30.07.19;42448;40544;1904;0;DPS
31.07.19;43620;42542;1078;0;DPS
01.08.19;69937;68231;1706;0;DPS
02.08.19;50546;49525;1021;0;DPS
03.08.19;35185;34536;649;0;DPS
05.08.19;55415;52180;3235;0;DPS
06.08.19;50349;49134;1215;0;DPS
07.08.19;54210;52499;1711;0;DPS
08.08.19;62586;61345;1241;0;DPS
09.08.19;57879;56722;1157;0;DPS
10.08.19;32350;31778;572;0;DPS
12.08.19;52989;52018;971;0;DPS
13.08.19;45021;43931;1090;0;DPS
14.08.19;45441;44452;989;0;DPS
15.08.19;66451;65087;1364;0;DPS
16.08.19;50648;49834;814;0;DPS
17.08.19;33574;30998;2576;0;DPS
19.08.19;53003;51977;1026;0;DPS
20.08.19;46041;44985;1056;0;DPS
21.08.19;48153;46722;1431;0;DPS
22.08.19;59081;57415;1666;0;DPS
23.08.19;45269;44599;670;0;DPS
24.08.19;29499;28903;596;0;DPS
26.08.19;50609;49753;856;0;DPS
27.08.19;40362;39736;626;0;DPS
28.08.19;51987;50913;1074;0;DPS
29.08.19;69309;62868;6441;0;DPS
30.08.19;52248;51374;874;0;DPS
31.08.19;34178;33576;602;0;DPS
02.09.19;56684;55772;912;0;DPS
03.09.19;49960;46346;3614;0;DPS
04.09.19;50200;48116;2084;0;DPS
05.09.19;63445;62390;1055;0;DPS
06.09.19;53100;51809;1291;0;DPS
07.09.19;39246;37431;1815;0;DPS
09.09.19;67087;64537;2550;0;DPS
10.09.19;53065;49679;3386;0;DPS
11.09.19;52560;50140;2420;0;DPS
12.09.19;69994;68210;1784;0;DPS
13.09.19;56270;55412;858;0;DPS
14.09.19;30972;30314;658;0;DPS
16.09.19;59626;57074;2552;0;DPS
17.09.19;47136;46014;1122;0;DPS
18.09.19;45833;44823;1010;0;DPS
19.09.19;58636;57174;1462;0;DPS
20.09.19;55663;52469;3194;0;DPS
21.09.19;33003;31749;1254;0;DPS
23.09.19;58427;57097;1330;0;DPS
24.09.19;42846;41950;896;0;DPS
25.09.19;46249;45067;1182;0;DPS
26.09.19;69348;67427;1921;0;DPS
27.09.19;53259;51688;1571;0;DPS
28.09.19;30842;30080;762;0;DPS
30.09.19;54702;53535;1167;0;DPS
01.10.19;66144;64470;1674;0;DPS
02.10.19;73142;71231;1911;0;DPS
03.10.19;16336;15977;359;0;DPS
04.10.19;42580;41592;988;0;DPS
05.10.19;46892;45461;1431;0;DPS
07.10.19;59705;58328;1377;0;DPS
08.10.19;72024;67411;4613;0;DPS
09.10.19;62201;59193;3008;0;DPS
10.10.19;65729;63949;1780;0;DPS
11.10.19;54205;53025;1180;0;DPS
12.10.19;26497;25826;671;0;DPS
14.10.19;46955;44596;2359;0;DPS
15.10.19;53691;50918;2773;0;DPS
16.10.19;50889;49014;1875;0;DPS
17.10.19;60689;58793;1896;0;DPS
18.10.19;50803;48538;2265;0;DPS
19.10.19;28037;27023;1014;0;DPS
21.10.19;53555;51778;1777;0;DPS
22.10.19;64054;61038;3016;0;DPS
23.10.19;51890;49537;2353;0;DPS
24.10.19;64889;59023;5866;0;DPS
25.10.19;48794;47383;1411;0;DPS
26.10.19;35478;31860;3618;0;DPS
28.10.19;55178;52419;2759;0;DPS
29.10.19;70809;67768;3041;0;DPS
30.10.19;61665;59367;2298;0;DPS
31.10.19;19271;18486;785;0;DPS
01.11.19;41418;40047;1371;0;DPS
02.11.19;72229;70457;1772;0;DPS
04.11.19;71312;68459;2853;0;DPS
05.11.19;70852;69223;1629;0;DPS
06.11.19;58071;55829;2242;0;DPS
07.11.19;67074;65215;1859;0;DPS
08.11.19;58669;57221;1448;0;DPS
09.11.19;31984;31200;784;0;DPS
11.11.19;57539;56155;1384;0;DPS
12.11.19;61528;60176;1352;0;DPS
13.11.19;55729;53543;2186;0;DPS
14.11.19;69348;66486;2862;0;DPS
15.11.19;55062;52842;2220;0;DPS
16.11.19;37825;36763;1062;0;DPS
18.11.19;58821;57436;1385;0;DPS
19.11.19;68217;64449;3768;0;DPS
20.11.19;60467;56509;3958;0;DPS
21.11.19;77656;74425;3231;0;DPS
22.11.19;56910;55350;1560;0;DPS
23.11.19;36679;32827;3852;0;DPS
25.11.19;61428;59725;1703;0;DPS
26.11.19;81669;77092;4577;0;DPS
27.11.19;70910;68815;2095;0;DPS
28.11.19;87410;83803;3607;0;DPS
29.11.19;66763;65370;1393;0;DPS
30.11.19;40945;39965;980;0;DPS
02.12.19;78068;74976;3092;0;DPS
03.12.19;88516;86092;2424;0;DPS
04.12.19;74502;71327;3175;0;DPS
05.12.19;81538;78932;2606;0;DPS
06.12.19;67460;66269;1191;0;DPS
07.12.19;38360;37079;1281;0;DPS
09.12.19;61400;60365;1035;0;DPS
10.12.19;72575;70873;1702;0;DPS
11.12.19;69121;64313;4808;0;DPS
12.12.19;75943;73845;2098;0;DPS
13.12.19;62077;60600;1477;0;DPS
14.12.19;39403;37778;1625;0;DPS
16.12.19;69514;68201;1313;0;DPS
17.12.19;85941;84505;1436;0;DPS
18.12.19;67377;65963;1414;0;DPS
19.12.19;77980;76667;1313;0;DPS
20.12.19;70110;68566;1544;0;DPS
21.12.19;83730;82166;1564;0;DPS
23.12.19;65739;64646;1093;0;DPS
24.12.19;57637;56138;1499;0;DPS
27.12.19;82817;80452;2365;0;DPS
28.12.19;61893;60733;1160;0;DPS
30.12.19;73853;72627;1226;0;DPS
31.12.19;48959;47814;1145;0;DPS
02.01.20;90386;88678;1708;0;DPS
03.01.20;54053;52672;1381;0;DPS
04.01.20;30773;29853;920;0;DPS
06.01.20;54349;53119;1230;0;DPS
07.01.20;48547;47180;1367;0;DPS
08.01.20;50141;49140;1001;0;DPS
09.01.20;72947;71378;1569;0;DPS
10.01.20;48477;47567;910;0;DPS
11.01.20;25812;25202;610;0;DPS
13.01.20;51402;50459;943;0;DPS
14.01.20;47946;45594;2352;0;DPS
15.01.20;52421;50630;1791;0;DPS
16.01.20;66937;65223;1714;0;DPS
17.01.20;61789;57888;3901;0;DPS
18.01.20;33849;32020;1829;0;DPS
20.01.20;58675;56594;2081;0;DPS
21.01.20;48218;46147;2071;0;DPS
22.01.20;48928;47310;1618;0;DPS
23.01.20;72894;70417;2477;0;DPS
24.01.20;60472;59117;1355;0;DPS
25.01.20;33865;33036;829;0;DPS
27.01.20;68156;59152;9004;0;DPS
28.01.20;49695;48433;1262;0;DPS
29.01.20;49069;47652;1417;0;DPS
30.01.20;71449;69551;1898;0;DPS
31.01.20;59707;58535;1172;0;DPS
01.02.20;36939;36112;827;0;DPS
03.02.20;66821;65317;1504;0;DPS
04.02.20;51674;49913;1761;0;DPS
05.02.20;56511;54192;2319;0;DPS
06.02.20;80442;78665;1777;0;DPS
07.02.20;58651;56873;1778;0;DPS
08.02.20;34029;33159;870;0;DPS
10.02.20;62811;60712;2099;0;DPS
11.02.20;46625;45517;1108;0;DPS
12.02.20;50882;49681;1201;0;DPS
13.02.20;78622;76611;2011;0;DPS
14.02.20;57970;56824;1146;0;DPS
15.02.20;34810;34090;720;0;DPS
17.02.20;62573;60705;1868;0;DPS
18.02.20;52920;51841;1079;0;DPS
19.02.20;57501;55894;1607;0;DPS
20.02.20;79255;77368;1887;0;DPS
21.02.20;61956;58667;3289;0;DPS
22.02.20;35070;34279;791;0;DPS
24.02.20;60914;59300;1614;0;DPS
25.02.20;54044;52493;1551;0;DPS
26.02.20;57260;55272;1988;0;DPS
27.02.20;92538;89707;2831;0;DPS
28.02.20;71652;69188;2464;0;DPS
29.02.20;49480;47711;1769;0;DPS
02.03.20;88277;85355;2922;0;DPS
03.03.20;69891;67650;2241;0;DPS
04.03.20;66520;63794;2726;0;DPS
05.03.20;95425;89484;5941;0;DPS
06.03.20;66665;65002;1663;0;DPS
07.03.20;38526;36480;2046;0;DPS
09.03.20;62904;61026;1878;0;DPS
10.03.20;52236;50661;1575;0;DPS
11.03.20;59885;58153;1732;0;DPS
12.03.20;79745;77468;2277;0;DPS
13.03.20;64871;62956;1915;0;DPS
14.03.20;42741;40821;1920;0;DPS
16.03.20;89086;86106;2980;0;DPS
17.03.20;77784;74643;3141;0;DPS
18.03.20;88121;84391;3730;0;DPS
19.03.20;75079;72380;2699;0;DPS
20.03.20;68561;66269;2292;0;DPS
21.03.20;28405;27282;1123;0;DPS
23.03.20;58230;56398;1832;0;DPS
24.03.20;60202;58433;1769;0;DPS
25.03.20;78264;75890;2374;0;DPS
26.03.20;89329;87020;2309;0;DPS
27.03.20;64376;62460;1916;0;DPS
28.03.20;29871;29162;709;0;DPS
30.03.20;65741;63219;2522;0;DPS
31.03.20;52437;51331;1106;0;DPS
01.04.20;59028;56213;2815;0;DPS
02.04.20;77042;74759;2283;0;DPS
03.04.20;57865;56041;1824;0;DPS
04.04.20;36897;35907;990;0;DPS
06.04.20;61591;60237;1354;0;DPS
07.04.20;70987;69244;1743;0;DPS
08.04.20;72892;70066;2826;0;DPS
09.04.20;56902;55631;1271;0;DPS
10.04.20;20497;20017;480;0;DPS
11.04.20;54099;52687;1412;0;DPS
14.04.20;41882;40989;893;0;DPS
15.04.20;63309;61603;1706;0;DPS
16.04.20;99836;96627;3209;0;DPS
17.04.20;76479;74338;2141;0;DPS
18.04.20;46834;45537;1297;0;DPS
20.04.20;66387;64872;1515;0;DPS
21.04.20;58121;56704;1417;0;DPS
22.04.20;58668;56682;1986;0;DPS
23.04.20;77164;74785;2379;0;DPS
24.04.20;58451;56964;1487;0;DPS
25.04.20;32232;31236;996;0;DPS
27.04.20;49290;48060;1230;0;DPS
28.04.20;70193;67224;2969;0;DPS
29.04.20;67404;65829;1575;0;DPS
30.04.20;45492;44240;1252;0;DPS
01.05.20;15202;14806;396;0;DPS
02.05.20;30482;29541;941;0;DPS
04.05.20;58497;56772;1725;0;DPS
05.05.20;54145;52759;1386;0;DPS
06.05.20;68664;66585;2079;0;DPS
07.05.20;84052;81957;2095;0;DPS
08.05.20;63200;61613;1587;0;DPS
09.05.20;35018;34033;985;0;DPS
11.05.20;57304;56072;1232;0;DPS
12.05.20;48637;47189;1448;0;DPS
13.05.20;49245;46915;2330;0;DPS
14.05.20;74550;70912;3638;0;DPS
15.05.20;56620;54456;2164;0;DPS
16.05.20;35190;34355;835;0;DPS
18.05.20;55789;54589;1200;0;DPS
19.05.20;82287;80122;2165;0;DPS
20.05.20;70414;68628;1786;0;DPS
21.05.20;20361;19766;595;0;DPS
22.05.20;38794;37847;947;0;DPS
23.05.20;39825;38163;1662;0;DPS
25.05.20;67187;64594;2593;0;DPS
26.05.20;56473;54972;1501;0;DPS
27.05.20;59432;57646;1786;0;DPS
28.05.20;75687;72960;2727;0;DPS
29.05.20;55578;53896;1682;0;DPS
30.05.20;59285;57682;1603;0;DPS
02.06.20;41125;40195;930;0;DPS
03.06.20;71605;69606;1999;0;DPS
04.06.20;92233;89725;2508;0;DPS
05.06.20;59404;55824;3580;0;DPS
06.06.20;36408;35479;929;0;DPS
08.06.20;63228;61996;1232;0;DPS
09.06.20;61218;59958;1260;0;DPS
10.06.20;74264;72698;1566;0;DPS
11.06.20;77266;74310;2956;0;DPS
12.06.20;49892;48398;1494;0;DPS
13.06.20;34177;33128;1049;0;DPS
15.06.20;62728;61278;1450;0;DPS
16.06.20;50847;49537;1310;0;DPS
17.06.20;58848;57113;1735;0;DPS
18.06.20;80943;78742;2201;0;DPS
19.06.20;49785;48642;1143;0;DPS
20.06.20;38015;35946;2069;0;DPS
22.06.20;55969;53466;2503;0;DPS
23.06.20;55859;54171;1688;0;DPS
24.06.20;52444;50933;1511;0;DPS
25.06.20;84378;82221;2157;0;DPS
26.06.20;63785;60983;2802;0;DPS
27.06.20;34831;33944;887;0;DPS
29.06.20;53836;52838;998;0;DPS
30.06.20;48814;47469;1345;0;DPS
01.07.20;55660;54044;1616;0;DPS
02.07.20;83430;81267;2163;0;DPS
03.07.20;52477;51319;1158;0;DPS
04.07.20;34350;33566;784;0;DPS
06.07.20;62131;60950;1181;0;DPS
07.07.20;55873;54880;993;0;DPS
08.07.20;60338;59050;1288;0;DPS
09.07.20;84381;82327;2054;0;DPS
10.07.20;50292;48853;1439;0;DPS
11.07.20;28993;28201;792;0;DPS
13.07.20;53355;52241;1114;0;DPS
14.07.20;63035;61833;1202;0;DPS
15.07.20;63384;61857;1527;0;DPS
16.07.20;80827;78394;2433;0;DPS
17.07.20;53260;51767;1493;0;DPS
18.07.20;27910;27135;775;0;DPS
20.07.20;54596;52126;2470;0;DPS
21.07.20;51869;50783;1086;0;DPS
22.07.20;50023;49018;1005;0;DPS
23.07.20;76952;74996;1956;0;DPS
24.07.20;47815;46793;1022;0;DPS
25.07.20;29047;28219;828;0;DPS
27.07.20;56914;56093;821;0;DPS
28.07.20;50889;49864;1025;0;DPS
29.07.20;61591;58353;3238;0;DPS
30.07.20;82717;80899;1818;0;DPS
31.07.20;52248;51321;927;0;DPS
01.08.20;31614;30777;837;0;DPS
03.08.20;54958;53979;979;0;DPS
04.08.20;55010;53859;1151;0;DPS
05.08.20;57237;55699;1538;0;DPS
06.08.20;88180;84813;3367;0;DPS
07.08.20;56298;53596;2702;0;DPS
08.08.20;36203;35303;900;0;DPS
10.08.20;57938;56379;1559;0;DPS
11.08.20;57437;56105;1332;0;DPS
12.08.20;60052;58731;1321;0;DPS
13.08.20;80503;78588;1915;0;DPS
14.08.20;51718;50638;1080;0;DPS
15.08.20;30720;29174;1546;0;DPS
17.08.20;54780;51727;3053;0;DPS
18.08.20;54189;53180;1009;0;DPS
19.08.20;53827;52538;1289;0;DPS
20.08.20;78221;76366;1855;0;DPS
21.08.20;48780;47695;1085;0;DPS
22.08.20;27159;26376;783;0;DPS
24.08.20;52617;51490;1127;0;DPS
25.08.20;55430;53800;1630;0;DPS
26.08.20;51055;49530;1525;0;DPS
27.08.20;75126;72979;2147;0;DPS
28.08.20;46040;45043;997;0;DPS
29.08.20;29011;28243;768;0;DPS
31.08.20;55373;54238;1135;0;DPS
01.09.20;62587;61023;1564;0;DPS
02.09.20;52255;50715;1540;0;DPS
03.09.20;82693;79890;2803;0;DPS
04.09.20;57897;55526;2371;0;DPS
05.09.20;30584;29963;621;0;DPS
07.09.20;59025;57251;1774;0;DPS
08.09.20;61061;59458;1603;0;DPS
09.09.20;51462;50239;1223;0;DPS
10.09.20;74126;72475;1651;0;DPS
11.09.20;51006;49395;1611;0;DPS
12.09.20;40929;36049;4880;0;DPS
14.09.20;59654;56910;2744;0;DPS
15.09.20;58756;57318;1438;0;DPS
16.09.20;50459;49283;1176;0;DPS
17.09.20;73436;71471;1965;0;DPS
18.09.20;53022;51395;1627;0;DPS
19.09.20;29239;28070;1169;0;DPS
21.09.20;39874;38727;1147;0;DPS
22.09.20;66198;64417;1781;0;DPS
23.09.20;50428;48599;1829;0;DPS
24.09.20;88328;86125;2203;0;DPS
25.09.20;53352;51445;1907;0;DPS
26.09.20;29698;28615;1083;0;DPS
28.09.20;60395;58918;1477;0;DPS
29.09.20;79345;77380;1965;0;DPS
30.09.20;54977;53647;1330;0;DPS
01.10.20;63585;62069;1516;0;DPS
02.10.20;39440;38477;963;0;DPS
05.10.20;61907;60260;1647;0;DPS
06.10.20;60871;59608;1263;0;DPS
07.10.20;57889;56344;1545;0;DPS
08.10.20;83830;80580;3250;0;DPS
09.10.20;52671;50801;1870;0;DPS
10.10.20;25409;23978;1431;0;DPS
12.10.20;54436;52424;2012;0;DPS
13.10.20;69956;66668;3288;0;DPS
14.10.20;48286;46375;1911;0;DPS
15.10.20;72686;70348;2338;0;DPS
16.10.20;49119;46985;2134;0;DPS
17.10.20;28556;26870;1686;0;DPS
19.10.20;58001;55521;2480;0;DPS
20.10.20;71060;67058;4002;0;DPS
21.10.20;49906;47122;2784;0;DPS
22.10.20;77875;75132;2743;0;DPS
23.10.20;55781;54252;1529;0;DPS
24.10.20;30244;29116;1128;0;DPS
26.10.20;71026;67292;3734;0;DPS
27.10.20;90307;87356;2951;0;DPS
28.10.20;65270;62448;2822;0;DPS
29.10.20;69390;67274;2116;0;DPS
30.10.20;42854;41362;1492;0;DPS
31.10.20;12280;11953;327;0;DPS
02.11.20;34656;33586;1070;0;DPS
03.11.20;59421;57195;2226;0;DPS
04.11.20;64302;61401;2901;0;DPS
05.11.20;86149;84569;1580;0;DPS
06.11.20;60630;58442;2188;0;DPS
07.11.20;38148;35625;2523;0;DPS
09.11.20;64180;61106;3074;0;DPS
10.11.20;80136;78475;1661;0;DPS
11.11.20;53005;50713;2292;0;DPS
12.11.20;83771;79942;3829;0;DPS
13.11.20;51378;49734;1644;0;DPS
14.11.20;27814;26065;1749;0;DPS
16.11.20;56881;54775;2106;0;DPS
17.11.20;81823;78919;2904;0;DPS
18.11.20;53841;50866;2975;0;DPS
19.11.20;75659;73223;2436;0;DPS
20.11.20;50423;48972;1451;0;DPS
21.11.20;32080;31316;764;0;DPS
23.11.20;61422;59963;1459;0;DPS
24.11.20;77225;75814;1411;0;DPS
25.11.20;54365;52630;1735;0;DPS
26.11.20;83057;81103;1954;0;DPS
27.11.20;57114;55584;1530;0;DPS
28.11.20;38878;34648;4230;0;DPS
30.11.20;68140;66004;2136;0;DPS
01.12.20;103839;101418;2421;0;DPS
02.12.20;71115;68362;2753;0;DPS
03.12.20;105492;103022;2470;0;DPS
04.12.20;59483;57610;1873;0;DPS
05.12.20;33789;32426;1363;0;DPS
07.12.20;61293;59888;1405;0;DPS
08.12.20;87566;85835;1731;0;DPS
09.12.20;63053;61268;1785;0;DPS
10.12.20;101951;99836;2115;0;DPS
11.12.20;62364;60825;1539;0;DPS
12.12.20;33676;31308;2368;0;DPS
14.12.20;58360;56804;1556;0;DPS
15.12.20;98450;95922;2528;0;DPS
16.12.20;71934;69568;2366;0;DPS
17.12.20;107653;104631;3022;0;DPS
18.12.20;81341;79929;1412;0;DPS
19.12.20;45495;43731;1764;0;DPS
21.12.20;71018;69171;1847;0;DPS
22.12.20;129499;127467;2032;0;DPS
23.12.20;78898;77186;1712;0;DPS
24.12.20;35898;35059;839;0;DPS
28.12.20;47643;46888;755;0;DPS
29.12.20;68552;67511;1041;0;DPS
30.12.20;64577;61392;3185;0;DPS
31.12.20;40832;39920;912;0;DPS
02.01.21;46681;45954;727;0;DPS
04.01.21;34561;33867;694;0;DPS
05.01.21;47474;46689;785;0;DPS
06.01.21;49090;47702;1388;0;DPS
07.01.21;69191;67875;1316;0;DPS
08.01.21;46541;45809;732;0;DPS
09.01.21;23009;22365;644;0;DPS
11.01.21;45206;44531;675;0;DPS
12.01.21;59215;58084;1131;0;DPS
13.01.21;50765;49583;1182;0;DPS
14.01.21;100356;97959;2397;0;DPS
15.01.21;53816;53165;651;0;DPS
18.01.21;53928;52314;1614;0;DPS
19.01.21;66094;65073;1021;0;DPS
20.01.21;63337;61277;2060;0;DPS
21.01.21;75500;72376;3124;0;DPS
22.01.21;62225;60865;1360;0;DPS
23.01.21;33730;32319;1411;0;DPS
25.01.21;46082;45029;1053;0;DPS
26.01.21;65338;61977;3361;0;DPS
27.01.21;58774;56884;1890;0;DPS
28.01.21;81636;78460;3176;0;DPS
29.01.21;50401;48660;1741;0;DPS
30.01.21;32496;31599;897;0;DPS
01.02.21;47916;46417;1499;0;DPS
02.02.21;58935;57638;1297;0;DPS
03.02.21;58002;55651;2351;0;DPS
04.02.21;78698;76777;1921;0;DPS
05.02.21;50323;49163;1160;0;DPS
06.02.21;33318;31219;2099;0;DPS
08.02.21;47847;45986;1861;0;DPS
09.02.21;62433;61776;657;0;DPS
10.02.21;63206;61883;1323;0;DPS
11.02.21;80229;77967;2262;0;DPS
12.02.21;54823;52319;2504;0;DPS
13.02.21;30841;30328;513;0;DPS
15.02.21;46332;44794;1538;0;DPS
16.02.21;64194;62577;1617;0;DPS
17.02.21;54107;51544;2563;0;DPS
18.02.21;72432;71343;1089;0;DPS
19.02.21;50882;49950;932;0;DPS
20.02.21;33494;32385;1109;0;DPS
22.02.21;46831;45821;1010;0;DPS
23.02.21;67646;65683;1963;0;DPS
24.02.21;63814;62152;1662;0;DPS
25.02.21;81733;78509;3224;0;DPS
26.02.21;49410;48488;922;0;DPS
27.02.21;27491;26927;564;0;DPS
01.03.21;42792;41897;895;0;DPS
02.03.21;69491;67446;2045;0;DPS
03.03.21;62303;58644;3659;0;DPS
04.03.21;76132;74838;1294;0;DPS
05.03.21;49367;47790;1577;0;DPS
06.03.21;28067;26849;1218;0;DPS
08.03.21;42363;41608;755;0;DPS
09.03.21;59801;58723;1078;0;DPS
10.03.21;56815;54896;1919;0;DPS
11.03.21;76903;75340;1563;0;DPS
12.03.21;49815;48940;875;0;DPS
13.03.21;26061;25042;1019;0;DPS
15.03.21;40533;38573;1960;0;DPS
16.03.21;59203;58418;785;0;DPS
17.03.21;63182;57418;5764;0;DPS
18.03.21;75831;74449;1382;0;DPS
19.03.21;73127;72201;926;0;DPS
20.03.21;32508;31795;713;0;DPS
22.03.21;46372;45229;1143;0;DPS
23.03.21;63494;62485;1009;0;DPS
24.03.21;60910;59094;1816;0;DPS
25.03.21;82769;81522;1247;0;DPS
26.03.21;56151;55201;950;0;DPS
27.03.21;38276;37702;574;0;DPS
29.03.21;49716;49071;645;0;DPS
30.03.21;99127;97810;1317;0;DPS
31.03.21;94677;92958;1719;0;DPS
01.04.21;44994;44018;976;0;DPS
02.04.21;13558;13286;272;0;DPS
03.04.21;12384;12129;255;0;DPS
06.04.21;64435;57776;6659;0;DPS
07.04.21;61106;58019;3087;0;DPS
08.04.21;78975;76510;2465;0;DPS
09.04.21;50378;49597;781;0;DPS
10.04.21;32974;31933;1041;0;DPS
12.04.21;47753;46947;806;0;DPS
13.04.21;62837;61823;1014;0;DPS
14.04.21;59317;58075;1242;0;DPS
15.04.21;71908;69495;2413;0;DPS
16.04.21;58832;52654;6178;0;DPS
17.04.21;29554;28334;1220;0;DPS
19.04.21;43846;43061;785;0;DPS
20.04.21;63814;62660;1154;0;DPS
21.04.21;64743;60978;3765;0;DPS
22.04.21;71608;68332;3276;0;DPS
23.04.21;52359;51533;826;0;DPS
24.04.21;36512;32641;3871;0;DPS
26.04.21;55499;54286;1213;0;DPS
27.04.21;67691;66282;1409;0;DPS
28.04.21;69669;68006;1663;0;DPS
29.04.21;66738;63706;3032;0;DPS
30.04.21;37336;35883;1453;0;DPS
03.05.21;34967;34179;788;0;DPS
04.05.21;58654;52410;6244;0;DPS
05.05.21;72911;70422;2488;1;DPS
06.05.21;97722;93630;4092;0;DPS
07.05.21;63734;62725;1009;0;DPS
08.05.21;34531;33839;692;0;DPS
10.05.21;50361;49371;990;0;DPS
11.05.21;91482;89440;2042;0;DPS
12.05.21;64945;63661;1284;0;DPS
13.05.21;17125;16808;317;0;DPS
14.05.21;30933;29398;1535;0;DPS
15.05.21;32130;30711;1419;0;DPS
17.05.21;49028;47916;1112;0;DPS
18.05.21;72630;71001;1629;0;DPS
19.05.21;58062;54909;3153;0;DPS
20.05.21;85027;82276;2751;0;DPS
21.05.21;48034;46990;1044;0;DPS
22.05.21;25782;25068;714;0;DPS
25.05.21;38746;38088;658;0;DPS
26.05.21;61899;60434;1465;0;DPS
27.05.21;81562;79534;2028;0;DPS
28.05.21;51221;49970;1251;0;DPS
29.05.21;34935;32039;2896;0;DPS
31.05.21;46707;45255;1452;0;DPS
01.06.21;70339;64094;6245;0;DPS
02.06.21;52611;51738;873;0;DPS
03.06.21;77432;69441;7991;0;DPS
04.06.21;51579;49576;2003;0;DPS
05.06.21;33593;32297;1296;0;DPS
07.06.21;46362;44800;1562;0;DPS
08.06.21;73602;70650;2952;0;DPS
09.06.21;64969;62820;2149;0;DPS
10.06.21;76680;74218;2462;0;DPS
11.06.21;54115;53017;1094;4;DPS
12.06.21;35757;34408;1347;2;DPS
14.06.21;49953;47099;2853;1;DPS
15.06.21;69802;66606;3196;0;DPS
16.06.21;63368;60933;2435;0;DPS
17.06.21;73214;71213;2001;0;DPS
18.06.21;53289;52482;807;0;DPS
19.06.21;32313;31486;827;0;DPS
21.06.21;44924;44002;922;0;DPS
22.06.21;58920;58031;889;0;DPS
23.06.21;56305;55171;1134;0;DPS
24.06.21;70213;66373;3840;0;DPS
25.06.21;52236;50947;1289;0;DPS
26.06.21;35219;32029;3190;0;DPS
28.06.21;50078;48516;1562;0;DPS
29.06.21;65302;63820;1482;0;DPS
30.06.21;54542;53009;1533;0;DPS
01.07.21;64022;62731;1291;0;DPS
02.07.21;54619;52620;1999;0;DPS
03.07.21;33297;31954;1343;0;DPS
05.07.21;48725;45185;3540;0;DPS
06.07.21;62308;61290;1018;0;DPS
07.07.21;62745;61344;1401;0;DPS
08.07.21;73111;71288;1823;0;DPS
09.07.21;50298;48777;1521;0;DPS
10.07.21;30901;30048;853;0;DPS
12.07.21;44844;44082;762;0;DPS
13.07.21;65148;64175;973;0;DPS
14.07.21;61709;60267;1442;0;DPS
15.07.21;64894;63309;1585;0;DPS
16.07.21;48006;45346;2660;0;DPS
17.07.21;30299;29597;702;0;DPS
19.07.21;43077;42407;670;0;DPS
20.07.21;60386;58632;1754;0;DPS
21.07.21;58895;55962;2933;0;DPS
22.07.21;64466;63371;1095;0;DPS
23.07.21;47249;45217;2032;0;DPS
24.07.21;30311;28708;1603;0;DPS
26.07.21;42087;41297;790;0;DPS
27.07.21;56256;54809;1447;0;DPS
28.07.21;58265;54949;3316;0;DPS
29.07.21;69415;66688;2727;0;DPS
30.07.21;48596;46443;2153;0;DPS
31.07.21;30860;30118;742;0;DPS
02.08.21;48580;47255;1325;0;DPS
03.08.21;66570;64714;1856;0;DPS
04.08.21;64723;63122;1601;0;DPS
05.08.21;71586;69922;1664;0;DPS
06.08.21;50222;49040;1182;0;DPS
07.08.21;31658;30877;781;0;DPS
09.08.21;43607;41339;2268;0;DPS
10.08.21;63099;61877;1222;0;DPS
11.08.21;64798;61298;3500;0;DPS
12.08.21;67368;65857;1511;0;DPS
13.08.21;50110;48685;1425;0;DPS
14.08.21;30400;29048;1352;0;DPS
16.08.21;42497;41732;765;0;DPS
17.08.21;59819;58927;892;0;DPS
18.08.21;57674;54940;2734;0;DPS
19.08.21;75101;73782;1319;0;DPS
20.08.21;56708;54274;2434;0;DPS
21.08.21;33874;32947;927;0;DPS
23.08.21;46028;45322;706;0;DPS
24.08.21;59901;58306;1595;0;DPS
25.08.21;61130;59121;2009;0;DPS
26.08.21;66613;65281;1332;0;DPS
27.08.21;49666;47602;2064;0;DPS
28.08.21;32976;30499;2477;0;DPS
30.08.21;54206;50899;3307;0;DPS
31.08.21;64383;61334;3049;0;DPS
01.09.21;70281;64371;5910;0;DPS
02.09.21;78963;72122;6841;0;DPS
03.09.21;53910;52309;1601;0;DPS
04.09.21;37397;31428;5969;0;DPS
06.09.21;53980;50483;3497;0;DPS
07.09.21;63042;61651;1391;0;DPS
08.09.21;62803;61923;880;0;DPS
09.09.21;70423;66176;4247;0;DPS
10.09.21;48229;47023;1206;0;DPS
11.09.21;27565;26964;601;0;DPS
13.09.21;42139;41149;990;0;DPS
14.09.21;59242;58064;1178;0;DPS
15.09.21;70921;69452;1469;0;DPS
16.09.21;84304;82366;1938;0;DPS
17.09.21;26292;25550;742;0;DPS
18.09.21;1365;1360;5;0;DPS
19.09.21;16137;15738;399;0;DPS
20.09.21;58554;57452;1102;0;DPS
21.09.21;58299;57513;786;0;DPS
22.09.21;57359;54789;2570;0;DPS
23.09.21;66427;64912;1515;0;DPS
24.09.21;48880;47443;1437;0;DPS
25.09.21;33150;30929;2221;0;DPS
27.09.21;49795;48950;845;0;DPS
28.09.21;72817;71816;1001;0;DPS
29.09.21;58548;57463;1085;0;DPS
30.09.21;60069;58454;1615;0;DPS
01.10.21;55065;53968;1097;0;DPS
02.10.21;26966;26594;372;0;DPS
04.10.21;51971;50911;1060;0;DPS
05.10.21;79112;77722;1390;0;DPS
06.10.21;54296;53583;713;0;DPS
07.10.21;59184;58420;764;0;DPS
08.10.21;48816;48186;630;0;DPS
09.10.21;24640;24278;362;0;DPS
11.10.21;42790;41860;930;0;DPS
12.10.21;68510;66426;2084;0;DPS
13.10.21;61996;61009;987;0;DPS
14.10.21;62337;60662;1675;0;DPS
15.10.21;55453;54278;1175;0;DPS
16.10.21;24397;23516;881;0;DPS
18.10.21;50611;47131;3480;0;DPS
19.10.21;72528;70400;2128;0;DPS
20.10.21;55639;53954;1685;0;DPS
21.10.21;57529;55281;2248;0;DPS
22.10.21;50360;48946;1414;0;DPS
23.10.21;25091;23487;1604;0;DPS
25.10.21;51641;49733;1908;0;DPS
26.10.21;77145;74754;2391;0;DPS
27.10.21;72569;69653;2916;0;DPS
28.10.21;74929;72247;2682;0;DPS
29.10.21;52497;50849;1648;0;DPS
30.10.21;31953;30423;1530;0;DPS
01.11.21;49484;46345;3139;0;DPS
02.11.21;81549;79153;2396;0;DPS
03.11.21;76804;74280;2524;0;DPS
04.11.21;82104;77578;4526;0;DPS
05.11.21;58306;56050;2256;0;DPS
06.11.21;32002;30275;1727;0;DPS
08.11.21;51951;49340;2611;0;DPS
09.11.21;67365;65241;2124;0;DPS
10.11.21;68803;66546;2257;0;DPS
11.11.21;77165;74862;2303;0;DPS
12.11.21;63340;60283;3057;0;DPS
13.11.21;36863;35613;1250;0;DPS
15.11.21;51917;50060;1857;0;DPS
16.11.21;62503;61008;1495;0;DPS
17.11.21;68532;66696;1836;0;DPS
18.11.21;76828;71587;5241;0;DPS
19.11.21;73210;70171;3039;0;DPS
20.11.21;35587;34625;962;0;DPS
22.11.21;58566;54605;3961;0;DPS
23.11.21;68311;66916;1395;0;DPS
24.11.21;64783;63251;1532;0;DPS
25.11.21;69864;67494;2370;0;DPS
26.11.21;61502;59984;1518;0;DPS
27.11.21;32889;31923;966;0;DPS
29.11.21;58307;54661;3646;0;DPS
30.11.21;71510;69701;1809;0;DPS
01.12.21;74488;72587;1901;0;DPS
02.12.21;82411;80667;1744;0;DPS
03.12.21;63107;61883;1224;0;DPS
04.12.21;34918;33923;995;0;DPS
06.12.21;57592;56597;995;0;DPS
07.12.21;86951;84896;2055;0;DPS
08.12.21;84102;78283;5819;0;DPS
09.12.21;76021;74143;1878;0;DPS
10.12.21;63343;60861;2482;0;DPS
11.12.21;28919;27976;943;0;DPS
13.12.21;48737;42349;607;0;DPS